"","month","EVENT_TYPE","STATE","CROPDMG","PROPDMG","FATALITIES","INJURIES","DMG","health_impact"
"1",1,"AVALANCHE","AK",0,536000,3,3,536000,6
"2",1,"AVALANCHE","CA",0,0,3,3,0,6
"3",1,"AVALANCHE","CO",0,401800,9,5,401800,14
"4",1,"AVALANCHE","ID",0,16000,5,6,16000,11
"5",1,"AVALANCHE","MT",0,0,6,1,0,7
"6",1,"AVALANCHE","NH",0,0,1,1,0,2
"7",1,"AVALANCHE","OR",0,0,2,1,0,3
"8",1,"AVALANCHE","UT",0,0,11,1,0,12
"9",1,"AVALANCHE","WA",0,1e+06,11,2,1e+06,13
"10",1,"AVALANCHE","WY",0,0,7,1,0,8
"11",1,"BLIZZARD","AK",0,0,1,2,0,3
"12",1,"BLIZZARD","DE",0,1e+06,0,0,1e+06,0
"13",1,"BLIZZARD","IA",0,625000,1,3,625000,4
"14",1,"BLIZZARD","ID",0,242000,0,1,242000,1
"15",1,"BLIZZARD","MD",0,160000,2,150,160000,152
"16",1,"BLIZZARD","MI",0,25000,0,0,25000,0
"17",1,"BLIZZARD","MN",0,3e+05,3,0,3e+05,3
"18",1,"BLIZZARD","MT",0,50000,0,0,50000,0
"19",1,"BLIZZARD","ND",0,74223000,5,75,74223000,80
"20",1,"BLIZZARD","NE",0,10000,1,0,10000,1
"21",1,"BLIZZARD","NJ",0,18800000,3,0,18800000,3
"22",1,"BLIZZARD","PA",0,18970000,7,0,18970000,7
"23",1,"BLIZZARD","SD",0,1e+06,3,15,1e+06,18
"24",1,"BLIZZARD","UT",0,4e+07,3,50,4e+07,53
"25",1,"BLIZZARD","VA",0,350000,1,1,350000,2
"26",1,"BLIZZARD","WI",0,11000,1,5,11000,6
"27",1,"BLIZZARD","WY",0,15000,0,0,15000,0
"28",1,"COASTAL FLOOD","AL",0,5000,0,0,5000,0
"29",1,"COASTAL FLOOD","CA",0,5e+05,0,0,5e+05,0
"30",1,"COASTAL FLOOD","DE",0,3300000,0,0,3300000,0
"31",1,"COASTAL FLOOD","GA",0,15000,0,0,15000,0
"32",1,"COASTAL FLOOD","MA",0,385000,0,0,385000,0
"33",1,"COASTAL FLOOD","MD",0,1510000,0,0,1510000,0
"34",1,"COASTAL FLOOD","ME",0,12000,0,0,12000,0
"35",1,"COASTAL FLOOD","NH",0,7500,0,0,7500,0
"36",1,"COASTAL FLOOD","NJ",0,29700000,0,0,29700000,0
"37",1,"COASTAL FLOOD","PR",0,35000,0,0,35000,0
"38",1,"COASTAL FLOOD","TX",0,5000,0,0,5000,0
"39",1,"COASTAL FLOOD","VA",0,1500000,0,0,1500000,0
"40",1,"COLD/WIND CHILL","AK",0,6000,1,0,6000,1
"41",1,"COLD/WIND CHILL","AL",0,0,2,0,0,2
"42",1,"COLD/WIND CHILL","AR",0,7e+05,1,0,7e+05,1
"43",1,"COLD/WIND CHILL","AZ",0,120000,0,0,120000,0
"44",1,"COLD/WIND CHILL","CA",1750000,230000,1,0,1980000,1
"45",1,"COLD/WIND CHILL","FL",284130000,0,3,1,284130000,4
"46",1,"COLD/WIND CHILL","GA",0,0,1,0,0,1
"47",1,"COLD/WIND CHILL","IA",0,1e+06,2,0,1e+06,2
"48",1,"COLD/WIND CHILL","ID",0,50000,0,0,50000,0
"49",1,"COLD/WIND CHILL","IL",0,0,22,6,0,28
"50",1,"COLD/WIND CHILL","IN",0,5e+06,7,0,5e+06,7
"51",1,"COLD/WIND CHILL","KS",0,4000,0,0,4000,0
"52",1,"COLD/WIND CHILL","KY",0,8000,0,0,8000,0
"53",1,"COLD/WIND CHILL","LA",1e+05,4e+05,3,0,5e+05,3
"54",1,"COLD/WIND CHILL","MA",0,0,1,3,0,4
"55",1,"COLD/WIND CHILL","ME",0,0,1,0,0,1
"56",1,"COLD/WIND CHILL","MI",0,51250000,8,30,51250000,38
"57",1,"COLD/WIND CHILL","MN",0,0,2,0,0,2
"58",1,"COLD/WIND CHILL","MO",0,5e+06,2,21,5e+06,23
"59",1,"COLD/WIND CHILL","MS",0,5e+05,1,0,5e+05,1
"60",1,"COLD/WIND CHILL","MT",0,0,1,0,0,1
"61",1,"COLD/WIND CHILL","NC",0,5e+05,12,0,5e+05,12
"62",1,"COLD/WIND CHILL","ND",0,0,1,0,0,1
"63",1,"COLD/WIND CHILL","NE",0,850000,0,0,850000,0
"64",1,"COLD/WIND CHILL","NH",0,0,1,1,0,2
"65",1,"COLD/WIND CHILL","NM",0,0,6,0,0,6
"66",1,"COLD/WIND CHILL","NV",0,50000,2,0,50000,2
"67",1,"COLD/WIND CHILL","NY",0,0,2,0,0,2
"68",1,"COLD/WIND CHILL","OH",0,211000,5,0,211000,5
"69",1,"COLD/WIND CHILL","OK",0,6e+05,5,0,6e+05,5
"70",1,"COLD/WIND CHILL","PA",0,5025000,8,129,5025000,137
"71",1,"COLD/WIND CHILL","SC",0,0,6,0,0,6
"72",1,"COLD/WIND CHILL","TN",0,0,5,0,0,5
"73",1,"COLD/WIND CHILL","TX",0,125000,5,0,125000,5
"74",1,"COLD/WIND CHILL","VA",0,5000,1,0,5000,1
"75",1,"COLD/WIND CHILL","WA",0,0,3,0,0,3
"76",1,"COLD/WIND CHILL","WI",0,30000,3,13,30000,16
"77",1,"COLD/WIND CHILL","WV",0,5030000,3,5,5030000,8
"78",1,"DEBRIS FLOW","AS",0,40000,0,0,40000,0
"79",1,"DEBRIS FLOW","CA",0,477500,10,0,477500,10
"80",1,"DEBRIS FLOW","CO",0,185000,1,12,185000,13
"81",1,"DEBRIS FLOW","ID",0,30000,0,0,30000,0
"82",1,"DEBRIS FLOW","MT",0,5000,0,0,5000,0
"83",1,"DEBRIS FLOW","NC",0,2e+05,0,2,2e+05,2
"84",1,"DEBRIS FLOW","OR",0,470000,0,5,470000,5
"85",1,"DEBRIS FLOW","PA",0,50000,0,0,50000,0
"86",1,"DEBRIS FLOW","PR",0,5000,1,1,5000,2
"87",1,"DEBRIS FLOW","WA",0,13048000,4,0,13048000,4
"88",1,"DENSE FOG","CA",0,2560000,7,108,2560000,115
"89",1,"DENSE FOG","ID",0,10000,0,0,10000,0
"90",1,"DENSE FOG","IN",0,420000,0,0,420000,0
"91",1,"DENSE FOG","KS",0,0,1,0,0,1
"92",1,"DENSE FOG","LA",0,115000,1,70,115000,71
"93",1,"DENSE FOG","ME",0,0,0,24,0,24
"94",1,"DENSE FOG","NE",0,40000,0,0,40000,0
"95",1,"DENSE FOG","NY",0,0,0,2,0,2
"96",1,"DENSE FOG","OH",0,150000,0,0,150000,0
"97",1,"DENSE FOG","OR",0,10000,1,5,10000,6
"98",1,"DENSE FOG","UT",0,7e+05,2,15,7e+05,17
"99",1,"DENSE FOG","WA",0,140000,0,3,140000,3
"100",1,"DROUGHT","OK",750000,15775000,0,0,16525000,0
"101",1,"DROUGHT","TX",1040295000,8e+06,0,0,1048295000,0
"102",1,"DUST STORM","AZ",0,96000,2,46,96000,48
"103",1,"DUST STORM","CA",0,45000,0,0,45000,0
"104",1,"EXTREME COLD/WIND CHILL","AZ",0,1030000,0,0,1030000,0
"105",1,"EXTREME COLD/WIND CHILL","FL",17050000,0,1,0,17050000,1
"106",1,"EXTREME COLD/WIND CHILL","IA",0,750000,1,0,750000,1
"107",1,"EXTREME COLD/WIND CHILL","IL",0,0,27,1,0,28
"108",1,"EXTREME COLD/WIND CHILL","KY",0,0,0,1,0,1
"109",1,"EXTREME COLD/WIND CHILL","MI",0,0,1,0,0,1
"110",1,"EXTREME COLD/WIND CHILL","MN",0,5000,5,0,5000,5
"111",1,"EXTREME COLD/WIND CHILL","MS",0,0,1,0,0,1
"112",1,"EXTREME COLD/WIND CHILL","MT",0,0,1,0,0,1
"113",1,"EXTREME COLD/WIND CHILL","ND",0,0,2,0,0,2
"114",1,"EXTREME COLD/WIND CHILL","NE",0,0,2,2,0,4
"115",1,"EXTREME COLD/WIND CHILL","NJ",0,0,6,7,0,13
"116",1,"EXTREME COLD/WIND CHILL","NM",0,0,1,0,0,1
"117",1,"EXTREME COLD/WIND CHILL","NY",0,420000,7,0,420000,7
"118",1,"EXTREME COLD/WIND CHILL","OH",0,0,1,0,0,1
"119",1,"EXTREME COLD/WIND CHILL","OR",0,0,1,0,0,1
"120",1,"EXTREME COLD/WIND CHILL","PA",0,105000,11,1,105000,12
"121",1,"EXTREME COLD/WIND CHILL","SC",0,0,1,1,0,2
"122",1,"EXTREME COLD/WIND CHILL","SD",0,0,2,2,0,4
"123",1,"EXTREME COLD/WIND CHILL","TN",0,0,1,0,0,1
"124",1,"EXTREME COLD/WIND CHILL","VT",0,1e+05,0,0,1e+05,0
"125",1,"EXTREME COLD/WIND CHILL","WI",0,0,2,0,0,2
"126",1,"EXTREME COLD/WIND CHILL","WV",0,0,1,0,0,1
"127",1,"FLASH FLOOD","AL",252000,3486000,4,1,3738000,5
"128",1,"FLASH FLOOD","AR",0,8184300,2,0,8184300,2
"129",1,"FLASH FLOOD","AS",15000,1e+05,0,0,115000,0
"130",1,"FLASH FLOOD","AZ",0,6030000,1,0,6030000,1
"131",1,"FLASH FLOOD","CA",63500000,186423000,10,3,249923000,13
"132",1,"FLASH FLOOD","FL",0,1951000,0,0,1951000,0
"133",1,"FLASH FLOOD","GA",5000,12255400,0,2,12260400,2
"134",1,"FLASH FLOOD","HI",0,3836000,0,0,3836000,0
"135",1,"FLASH FLOOD","IL",0,919000,1,1,919000,2
"136",1,"FLASH FLOOD","IN",0,4625000,1,1,4625000,2
"137",1,"FLASH FLOOD","KY",0,2174000,1,1,2174000,2
"138",1,"FLASH FLOOD","LA",0,7896000,0,0,7896000,0
"139",1,"FLASH FLOOD","MD",0,11828000,0,1,11828000,1
"140",1,"FLASH FLOOD","MO",0,4141000,3,2,4141000,5
"141",1,"FLASH FLOOD","MS",0,9392500,1,0,9392500,1
"142",1,"FLASH FLOOD","NC",0,16307000,6,10,16307000,16
"143",1,"FLASH FLOOD","NM",1000,15000,0,0,16000,0
"144",1,"FLASH FLOOD","NV",0,6602000,0,0,6602000,0
"145",1,"FLASH FLOOD","NY",5e+05,115955000,7,0,116455000,7
"146",1,"FLASH FLOOD","OH",0,7977000,0,0,7977000,0
"147",1,"FLASH FLOOD","OK",0,50000,0,0,50000,0
"148",1,"FLASH FLOOD","PA",0,138728500,14,0,138728500,14
"149",1,"FLASH FLOOD","PR",0,590000,1,0,590000,1
"150",1,"FLASH FLOOD","SC",0,232000,1,3,232000,4
"151",1,"FLASH FLOOD","TN",1000,4035000,1,13,4036000,14
"152",1,"FLASH FLOOD","TX",0,2071000,5,1,2071000,6
"153",1,"FLASH FLOOD","UT",0,5500000,0,11,5500000,11
"154",1,"FLASH FLOOD","VA",0,60408000,1,0,60408000,1
"155",1,"FLASH FLOOD","VT",0,515000,0,0,515000,0
"156",1,"FLASH FLOOD","WV",0,25045500,2,0,25045500,2
"157",1,"FLOOD","AK",0,1605000,0,0,1605000,0
"158",1,"FLOOD","AL",0,850000,0,0,850000,0
"159",1,"FLOOD","AR",0,244000,0,0,244000,0
"160",1,"FLOOD","AS",0,40000,0,0,40000,0
"161",1,"FLOOD","AZ",0,24687000,1,8,24687000,9
"162",1,"FLOOD","CA",108700000,115932736000,8,12,116041436000,20
"163",1,"FLOOD","CT",0,587000,0,0,587000,0
"164",1,"FLOOD","DC",0,1e+07,0,0,1e+07,0
"165",1,"FLOOD","DE",0,0,0,1,0,1
"166",1,"FLOOD","FL",4e+05,5349000,0,0,5749000,0
"167",1,"FLOOD","GA",0,146000,0,0,146000,0
"168",1,"FLOOD","HI",0,24000,0,0,24000,0
"169",1,"FLOOD","IA",0,5000,0,0,5000,0
"170",1,"FLOOD","ID",0,1483000,0,0,1483000,0
"171",1,"FLOOD","IL",0,8245000,0,0,8245000,0
"172",1,"FLOOD","IN",50000,82909000,13,2,82959000,15
"173",1,"FLOOD","KY",30000,1481000,1,0,1511000,1
"174",1,"FLOOD","LA",0,4045000,1,4,4045000,5
"175",1,"FLOOD","MA",0,9e+05,0,0,9e+05,0
"176",1,"FLOOD","MD",0,60023000,0,2,60023000,2
"177",1,"FLOOD","ME",0,1454000,0,1,1454000,1
"178",1,"FLOOD","MI",0,33000,0,0,33000,0
"179",1,"FLOOD","MO",0,56500,2,0,56500,2
"180",1,"FLOOD","MS",0,8161000,1,0,8161000,1
"181",1,"FLOOD","NC",50000,2630000,0,1,2680000,1
"182",1,"FLOOD","NE",0,12000,0,0,12000,0
"183",1,"FLOOD","NJ",0,13720000,1,3,13720000,4
"184",1,"FLOOD","NM",0,135000,0,0,135000,0
"185",1,"FLOOD","NV",0,662755000,2,50,662755000,52
"186",1,"FLOOD","NY",0,102756600,3,0,102756600,3
"187",1,"FLOOD","OH",0,73728500,3,1,73728500,4
"188",1,"FLOOD","OK",0,20000,0,0,20000,0
"189",1,"FLOOD","OR",18400000,107650000,1,0,126050000,1
"190",1,"FLOOD","PA",0,74329000,4,3,74329000,7
"191",1,"FLOOD","PR",0,24000,1,0,24000,1
"192",1,"FLOOD","SC",0,162000,0,0,162000,0
"193",1,"FLOOD","TN",0,20669000,7,0,20669000,7
"194",1,"FLOOD","TX",0,184000,0,0,184000,0
"195",1,"FLOOD","UT",0,300030000,1,6,300030000,7
"196",1,"FLOOD","VA",81000,15962000,4,1,16043000,5
"197",1,"FLOOD","VT",0,3909000,2,0,3909000,2
"198",1,"FLOOD","WA",0,86616000,1,0,86616000,1
"199",1,"FLOOD","WV",150000,52309000,0,1,52459000,1
"200",1,"FLOOD","WY",0,4000,0,0,4000,0
"201",1,"FREEZING FOG","IA",0,50000,0,0,50000,0
"202",1,"FREEZING FOG","KS",0,40000,0,0,40000,0
"203",1,"FREEZING FOG","MT",0,142000,0,0,142000,0
"204",1,"FREEZING FOG","WA",0,2e+06,0,0,2e+06,0
"205",1,"FROST/FREEZE","CA",1.42e+08,580000,0,0,142580000,0
"206",1,"FROST/FREEZE","FL",426425000,11220000,0,0,437645000,0
"207",1,"FROST/FREEZE","IA",0,650000,0,0,650000,0
"208",1,"FROST/FREEZE","ME",0,0,2,0,0,2
"209",1,"FROST/FREEZE","MT",0,2e+05,0,0,2e+05,0
"210",1,"FROST/FREEZE","NV",0,1500000,0,0,1500000,0
"211",1,"FROST/FREEZE","NY",0,5407000,0,0,5407000,0
"212",1,"FROST/FREEZE","SC",0,1e+05,0,0,1e+05,0
"213",1,"FROST/FREEZE","TX",0,45000,0,0,45000,0
"214",1,"FROST/FREEZE","UT",0,1e+05,0,0,1e+05,0
"215",1,"FROST/FREEZE","VT",0,7e+05,0,0,7e+05,0
"216",1,"FROST/FREEZE","WA",0,5e+05,2,5,5e+05,7
"217",1,"FROST/FREEZE","WV",0,50000,0,0,50000,0
"218",1,"HAIL","AL",42000,535000,0,0,577000,0
"219",1,"HAIL","AR",0,264940,0,0,264940,0
"220",1,"HAIL","CA",0,1e+05,0,0,1e+05,0
"221",1,"HAIL","FL",0,71250,0,0,71250,0
"222",1,"HAIL","GA",0,4202000,0,0,4202000,0
"223",1,"HAIL","ID",5e+05,60000,0,0,560000,0
"224",1,"HAIL","KY",0,90000,0,0,90000,0
"225",1,"HAIL","LA",0,65217500,0,0,65217500,0
"226",1,"HAIL","MI",5000,5000,0,0,10000,0
"227",1,"HAIL","MO",0,800900,0,0,800900,0
"228",1,"HAIL","MS",0,2575810,0,0,2575810,0
"229",1,"HAIL","NC",0,2000,0,0,2000,0
"230",1,"HAIL","OH",0,5000,0,0,5000,0
"231",1,"HAIL","OK",0,2645000,0,0,2645000,0
"232",1,"HAIL","PA",0,5000,0,0,5000,0
"233",1,"HAIL","SC",0,5000,0,0,5000,0
"234",1,"HAIL","TN",0,31730,0,0,31730,0
"235",1,"HAIL","TX",25000,65872000,0,0,65897000,0
"236",1,"HAIL","WV",0,45000,0,0,45000,0
"237",1,"HEAVY RAIN","AR",0,0,1,0,0,1
"238",1,"HEAVY RAIN","AZ",0,5005000,0,0,5005000,0
"239",1,"HEAVY RAIN","CA",1.92e+08,154169000,6,22,346169000,28
"240",1,"HEAVY RAIN","ID",0,50000,0,0,50000,0
"241",1,"HEAVY RAIN","IL",0,2000,0,0,2000,0
"242",1,"HEAVY RAIN","KY",0,10000,0,0,10000,0
"243",1,"HEAVY RAIN","ME",0,0,0,4,0,4
"244",1,"HEAVY RAIN","MI",0,5e+06,0,0,5e+06,0
"245",1,"HEAVY RAIN","NC",0,70000,0,0,70000,0
"246",1,"HEAVY RAIN","NV",0,15000,0,0,15000,0
"247",1,"HEAVY RAIN","NY",0,294000,0,0,294000,0
"248",1,"HEAVY RAIN","OR",0,75000,0,0,75000,0
"249",1,"HEAVY RAIN","TX",0,40000,0,0,40000,0
"250",1,"HEAVY RAIN","VT",0,451000,0,0,451000,0
"251",1,"HEAVY RAIN","WA",0,11450000,0,15,11450000,15
"252",1,"HEAVY SNOW","AK",10000,366000,1,2,376000,3
"253",1,"HEAVY SNOW","AL",0,300,0,0,300,0
"254",1,"HEAVY SNOW","AR",20000,275060,0,0,295060,0
"255",1,"HEAVY SNOW","AZ",0,50000,2,0,50000,2
"256",1,"HEAVY SNOW","CA",0,5900000,16,6,5900000,22
"257",1,"HEAVY SNOW","CO",0,5e+05,1,4,5e+05,5
"258",1,"HEAVY SNOW","CT",0,173000,0,0,173000,0
"259",1,"HEAVY SNOW","DE",0,0,0,30,0,30
"260",1,"HEAVY SNOW","IA",0,3089900,2,0,3089900,2
"261",1,"HEAVY SNOW","ID",0,5696000,2,0,5696000,2
"262",1,"HEAVY SNOW","IL",300,53500,2,7,53800,9
"263",1,"HEAVY SNOW","KS",0,376000,0,1,376000,1
"264",1,"HEAVY SNOW","KY",0,21050,3,0,21050,3
"265",1,"HEAVY SNOW","MA",0,32474000,0,0,32474000,0
"266",1,"HEAVY SNOW","MD",0,1e+05,0,0,1e+05,0
"267",1,"HEAVY SNOW","ME",0,7500000,0,0,7500000,0
"268",1,"HEAVY SNOW","MI",0,8195000,0,6,8195000,6
"269",1,"HEAVY SNOW","MN",0,8000,0,0,8000,0
"270",1,"HEAVY SNOW","MO",700,3270020,0,0,3270720,0
"271",1,"HEAVY SNOW","MS",0,1780000,0,0,1780000,0
"272",1,"HEAVY SNOW","MT",0,110000,0,0,110000,0
"273",1,"HEAVY SNOW","NC",0,880000,2,1,880000,3
"274",1,"HEAVY SNOW","NH",0,420000,0,1,420000,1
"275",1,"HEAVY SNOW","NJ",0,1.1e+07,0,0,1.1e+07,0
"276",1,"HEAVY SNOW","NM",0,0,1,6,0,7
"277",1,"HEAVY SNOW","NV",0,540000,0,1,540000,1
"278",1,"HEAVY SNOW","NY",0,15682000,0,2,15682000,2
"279",1,"HEAVY SNOW","OH",0,11193000,2,19,11193000,21
"280",1,"HEAVY SNOW","OK",0,6731000,0,0,6731000,0
"281",1,"HEAVY SNOW","OR",0,0,1,4,0,5
"282",1,"HEAVY SNOW","PA",0,11786000,4,187,11786000,191
"283",1,"HEAVY SNOW","RI",0,35000,0,0,35000,0
"284",1,"HEAVY SNOW","SD",0,50000,0,0,50000,0
"285",1,"HEAVY SNOW","TN",0,306160,0,0,306160,0
"286",1,"HEAVY SNOW","TX",0,1075000,0,0,1075000,0
"287",1,"HEAVY SNOW","UT",20000,50591500,4,52,50611500,56
"288",1,"HEAVY SNOW","VA",0,2679000,2,1,2679000,3
"289",1,"HEAVY SNOW","VT",0,605000,0,0,605000,0
"290",1,"HEAVY SNOW","WA",0,12380000,2,16,12380000,18
"291",1,"HEAVY SNOW","WI",0,130000,1,20,130000,21
"292",1,"HEAVY SNOW","WV",0,63265000,6,7,63265000,13
"293",1,"HEAVY SNOW","WY",0,4000,0,0,4000,0
"294",1,"HIGH SURF","CA",0,18905000,6,6,18905000,12
"295",1,"HIGH SURF","FL",0,0,1,1,0,2
"296",1,"HIGH SURF","GU",0,0,6,3,0,9
"297",1,"HIGH SURF","HI",0,170000,5,4,170000,9
"298",1,"HIGH SURF","PR",0,0,1,0,0,1
"299",1,"HIGH SURF","VA",0,0,1,1,0,2
"300",1,"HIGH SURF","VI",0,0,1,0,0,1
"301",1,"HIGH SURF","WA",0,90000,0,0,90000,0
"302",1,"HIGH WIND","AK",0,9201600,0,8,9201600,8
"303",1,"HIGH WIND","AL",0,594000,0,0,594000,0
"304",1,"HIGH WIND","AR",0,564000,0,0,564000,0
"305",1,"HIGH WIND","AS",23000,8000,0,0,31000,0
"306",1,"HIGH WIND","AZ",0,622000,0,0,622000,0
"307",1,"HIGH WIND","CA",29210000,18917970,6,30,48127970,36
"308",1,"HIGH WIND","CO",0,1038000,0,8,1038000,8
"309",1,"HIGH WIND","CT",0,330000,0,0,330000,0
"310",1,"HIGH WIND","DC",0,270000,0,0,270000,0
"311",1,"HIGH WIND","DE",0,150000,0,0,150000,0
"312",1,"HIGH WIND","FL",0,126000,1,6,126000,7
"313",1,"HIGH WIND","GA",0,217000,0,1,217000,1
"314",1,"HIGH WIND","GU",0,50000,0,1,50000,1
"315",1,"HIGH WIND","HI",0,570000,1,0,570000,1
"316",1,"HIGH WIND","IA",0,1340000,0,2,1340000,2
"317",1,"HIGH WIND","ID",0,61000,3,1,61000,4
"318",1,"HIGH WIND","IL",0,385000,0,0,385000,0
"319",1,"HIGH WIND","IN",0,51510,1,0,51510,1
"320",1,"HIGH WIND","KS",0,353000,1,0,353000,1
"321",1,"HIGH WIND","KY",0,294000,0,0,294000,0
"322",1,"HIGH WIND","LA",0,10000,0,0,10000,0
"323",1,"HIGH WIND","MA",0,2041000,1,0,2041000,1
"324",1,"HIGH WIND","MD",0,1850000,0,2,1850000,2
"325",1,"HIGH WIND","ME",0,270000,0,0,270000,0
"326",1,"HIGH WIND","MN",0,850500,0,0,850500,0
"327",1,"HIGH WIND","MO",0,1717000,0,0,1717000,0
"328",1,"HIGH WIND","MS",0,1140000,0,1,1140000,1
"329",1,"HIGH WIND","MT",0,549000,2,5,549000,7
"330",1,"HIGH WIND","NC",25000,659000,0,0,684000,0
"331",1,"HIGH WIND","ND",0,90000,0,0,90000,0
"332",1,"HIGH WIND","NE",0,37000,0,0,37000,0
"333",1,"HIGH WIND","NH",0,35000,0,0,35000,0
"334",1,"HIGH WIND","NJ",0,6680000,0,4,6680000,4
"335",1,"HIGH WIND","NM",1000,389000,0,0,390000,0
"336",1,"HIGH WIND","NV",0,1306500,0,1,1306500,1
"337",1,"HIGH WIND","NY",0,7214500,1,8,7214500,9
"338",1,"HIGH WIND","OH",0,1347000,1,6,1347000,7
"339",1,"HIGH WIND","OK",0,76700,0,0,76700,0
"340",1,"HIGH WIND","OR",5e+06,3793500,2,9,8793500,11
"341",1,"HIGH WIND","PA",0,1405000,0,2,1405000,2
"342",1,"HIGH WIND","RI",0,250000,0,2,250000,2
"343",1,"HIGH WIND","SC",0,30000,0,0,30000,0
"344",1,"HIGH WIND","SD",0,140000,0,0,140000,0
"345",1,"HIGH WIND","TN",65000,1210500,0,0,1275500,0
"346",1,"HIGH WIND","TX",0,11563500,4,6,11563500,10
"347",1,"HIGH WIND","UT",1000,624000,0,0,625000,0
"348",1,"HIGH WIND","VA",0,3232300,0,3,3232300,3
"349",1,"HIGH WIND","VT",0,426000,1,1,426000,2
"350",1,"HIGH WIND","WA",23000,21066000,7,34,21089000,41
"351",1,"HIGH WIND","WV",0,953700,0,0,953700,0
"352",1,"HIGH WIND","WY",0,418500,0,5,418500,5
"353",1,"HURRICANE/TYPHOON","AS",5e+05,50500000,0,20,5.1e+07,20
"354",1,"ICE STORM","AK",10000,104000,0,3,114000,3
"355",1,"ICE STORM","AL",0,4331000,0,0,4331000,0
"356",1,"ICE STORM","AR",0,142725000,1,0,142725000,1
"357",1,"ICE STORM","AZ",0,0,5,0,0,5
"358",1,"ICE STORM","CT",0,0,1,3,0,4
"359",1,"ICE STORM","DC",0,20000,0,0,20000,0
"360",1,"ICE STORM","GA",0,51138000,0,6,51138000,6
"361",1,"ICE STORM","IA",0,6939460,0,2,6939460,2
"362",1,"ICE STORM","IL",300,399500,0,1,399800,1
"363",1,"ICE STORM","IN",0,310000,0,2,310000,2
"364",1,"ICE STORM","KS",0,37700000,4,12,37700000,16
"365",1,"ICE STORM","KY",0,35607000,0,0,35607000,0
"366",1,"ICE STORM","LA",20000,12560000,2,15,12580000,17
"367",1,"ICE STORM","MA",0,135000,0,1,135000,1
"368",1,"ICE STORM","MD",20000,3251000,0,0,3271000,0
"369",1,"ICE STORM","ME",0,3.13e+08,1,0,3.13e+08,1
"370",1,"ICE STORM","MI",0,1320000,0,2,1320000,2
"371",1,"ICE STORM","MN",0,382000,0,1,382000,1
"372",1,"ICE STORM","MO",500,60007000,0,0,60007500,0
"373",1,"ICE STORM","MS",60000,880000,0,0,940000,0
"374",1,"ICE STORM","MT",0,5000,0,0,5000,0
"375",1,"ICE STORM","NC",0,17500800,0,0,17500800,0
"376",1,"ICE STORM","NE",0,86500,0,4,86500,4
"377",1,"ICE STORM","NH",0,28005000,0,1,28005000,1
"378",1,"ICE STORM","NV",0,0,3,2,0,5
"379",1,"ICE STORM","NY",0,37025000,2,24,37025000,26
"380",1,"ICE STORM","OH",0,128790000,1,38,128790000,39
"381",1,"ICE STORM","OK",0,301500000,0,0,301500000,0
"382",1,"ICE STORM","OR",0,1050000,1,5,1050000,6
"383",1,"ICE STORM","PA",0,311000,0,65,311000,65
"384",1,"ICE STORM","RI",0,5e+05,0,0,5e+05,0
"385",1,"ICE STORM","SC",0,46530500,0,0,46530500,0
"386",1,"ICE STORM","SD",0,5e+05,3,16,5e+05,19
"387",1,"ICE STORM","TN",0,655000,1,0,655000,1
"388",1,"ICE STORM","TX",0,19468000,7,26,19468000,33
"389",1,"ICE STORM","VA",75000,1057000,0,2,1132000,2
"390",1,"ICE STORM","VT",0,6230000,0,1,6230000,1
"391",1,"ICE STORM","WA",0,266000,1,5,266000,6
"392",1,"ICE STORM","WI",0,66500,0,14,66500,14
"393",1,"ICE STORM","WV",0,127000,1,0,127000,1
"394",1,"ICE STORM","WY",0,12000,0,1,12000,1
"395",1,"LAKE-EFFECT SNOW","NY",0,536000,0,0,536000,0
"396",1,"LAKE-EFFECT SNOW","OH",0,2865000,0,0,2865000,0
"397",1,"LAKE-EFFECT SNOW","PA",0,2065000,0,0,2065000,0
"398",1,"LIGHTNING","AL",0,635000,0,1,635000,1
"399",1,"LIGHTNING","AR",0,171000,0,1,171000,1
"400",1,"LIGHTNING","CA",0,1015000,1,2,1015000,3
"401",1,"LIGHTNING","CT",0,0,0,1,0,1
"402",1,"LIGHTNING","FL",0,801500,1,2,801500,3
"403",1,"LIGHTNING","GA",0,989505,0,3,989505,3
"404",1,"LIGHTNING","HI",0,10000,0,0,10000,0
"405",1,"LIGHTNING","IL",0,15000,0,1,15000,1
"406",1,"LIGHTNING","IN",0,215000,0,0,215000,0
"407",1,"LIGHTNING","KY",0,125000,0,0,125000,0
"408",1,"LIGHTNING","LA",0,287000,1,4,287000,5
"409",1,"LIGHTNING","MA",0,27000,0,1,27000,1
"410",1,"LIGHTNING","MD",0,0,0,1,0,1
"411",1,"LIGHTNING","MO",0,1e+05,0,0,1e+05,0
"412",1,"LIGHTNING","MS",0,61010,0,1,61010,1
"413",1,"LIGHTNING","NC",0,135000,0,2,135000,2
"414",1,"LIGHTNING","NJ",0,0,0,1,0,1
"415",1,"LIGHTNING","NY",0,234000,0,0,234000,0
"416",1,"LIGHTNING","OH",0,50000,0,0,50000,0
"417",1,"LIGHTNING","OK",0,574000,0,5,574000,5
"418",1,"LIGHTNING","OR",0,15000,0,0,15000,0
"419",1,"LIGHTNING","PA",0,1e+05,0,1,1e+05,1
"420",1,"LIGHTNING","RI",0,5000,0,0,5000,0
"421",1,"LIGHTNING","SC",0,40000,1,1,40000,2
"422",1,"LIGHTNING","TN",0,20000,0,2,20000,2
"423",1,"LIGHTNING","TX",0,355500,0,2,355500,2
"424",1,"LIGHTNING","VA",0,29000,0,0,29000,0
"425",1,"LIGHTNING","VT",0,298000,1,2,298000,3
"426",1,"LIGHTNING","WI",0,15000,0,0,15000,0
"427",1,"MARINE HAIL","AK",0,0,7,5,0,12
"428",1,"MARINE HIGH WIND","PK",0,10000,0,0,10000,0
"429",1,"MARINE STRONG WIND","GM",0,100,0,0,100,0
"430",1,"MARINE STRONG WIND","PZ",0,5000,0,0,5000,0
"431",1,"MARINE THUNDERSTORM WIND","GM",0,50100,0,0,50100,0
"432",1,"OTHER EVENT NON IDENTIFIED","KS",0,60000,1,4,60000,5
"433",1,"OTHER EVENT NON IDENTIFIED","NY",0,0,1,4,0,5
"434",1,"OTHER EVENT NON IDENTIFIED","OH",0,0,0,166,0,166
"435",1,"OTHER EVENT NON IDENTIFIED","PA",0,0,0,42,0,42
"436",1,"OTHER EVENT NON IDENTIFIED","RI",0,50000,0,0,50000,0
"437",1,"RIP CURRENT","CA",0,0,3,30,0,33
"438",1,"RIP CURRENT","FL",0,0,3,5,0,8
"439",1,"RIP CURRENT","GU",0,2000,7,19,2000,26
"440",1,"RIP CURRENT","VI",0,0,1,1,0,2
"441",1,"SEICHE","NY",0,50000,0,0,50000,0
"442",1,"STORM SURGE/TIDE","AK",0,20000,0,2,20000,2
"443",1,"STORM SURGE/TIDE","CA",0,590000,0,28,590000,28
"444",1,"STORM SURGE/TIDE","FL",0,4500000,0,0,4500000,0
"445",1,"STORM SURGE/TIDE","MA",0,1375000,0,0,1375000,0
"446",1,"STORM SURGE/TIDE","MD",0,25000,0,0,25000,0
"447",1,"STORM SURGE/TIDE","ME",0,483000,0,0,483000,0
"448",1,"STORM SURGE/TIDE","NH",0,75000,0,0,75000,0
"449",1,"STRONG WIND","AK",0,198500,0,0,198500,0
"450",1,"STRONG WIND","AL",0,143500,0,0,143500,0
"451",1,"STRONG WIND","AR",0,315000,1,0,315000,1
"452",1,"STRONG WIND","AZ",0,5000,0,0,5000,0
"453",1,"STRONG WIND","CA",12000,4530000,1,4,4542000,5
"454",1,"STRONG WIND","CT",0,240000,0,0,240000,0
"455",1,"STRONG WIND","DE",0,46950,0,0,46950,0
"456",1,"STRONG WIND","FL",0,1000,0,0,1000,0
"457",1,"STRONG WIND","GA",0,460750,0,2,460750,2
"458",1,"STRONG WIND","HI",0,0,0,3,0,3
"459",1,"STRONG WIND","IA",0,6000,0,0,6000,0
"460",1,"STRONG WIND","ID",0,38000,0,0,38000,0
"461",1,"STRONG WIND","IL",0,38000,0,0,38000,0
"462",1,"STRONG WIND","IN",0,22000,0,0,22000,0
"463",1,"STRONG WIND","KS",0,29000,0,1,29000,1
"464",1,"STRONG WIND","KY",0,78000,0,0,78000,0
"465",1,"STRONG WIND","LA",0,30000,0,0,30000,0
"466",1,"STRONG WIND","MA",0,154000,0,0,154000,0
"467",1,"STRONG WIND","MD",0,119600,0,0,119600,0
"468",1,"STRONG WIND","MI",0,1000,0,0,1000,0
"469",1,"STRONG WIND","MO",0,22000,0,0,22000,0
"470",1,"STRONG WIND","MS",0,556000,0,0,556000,0
"471",1,"STRONG WIND","NC",0,94000,2,1,94000,3
"472",1,"STRONG WIND","NH",0,5000,1,0,5000,1
"473",1,"STRONG WIND","NJ",0,537200,0,0,537200,0
"474",1,"STRONG WIND","NM",0,23000,0,0,23000,0
"475",1,"STRONG WIND","NV",0,800,0,0,800,0
"476",1,"STRONG WIND","NY",0,226500,1,3,226500,4
"477",1,"STRONG WIND","OH",0,20000,0,0,20000,0
"478",1,"STRONG WIND","OR",0,200500,0,0,200500,0
"479",1,"STRONG WIND","PA",0,275830,0,3,275830,3
"480",1,"STRONG WIND","RI",0,15000,0,0,15000,0
"481",1,"STRONG WIND","SC",0,86000,0,0,86000,0
"482",1,"STRONG WIND","SD",0,3500000,0,0,3500000,0
"483",1,"STRONG WIND","TN",0,8000,0,0,8000,0
"484",1,"STRONG WIND","TX",0,860000,2,1,860000,3
"485",1,"STRONG WIND","UT",0,12000,0,0,12000,0
"486",1,"STRONG WIND","VA",0,55000,0,0,55000,0
"487",1,"STRONG WIND","VI",0,1000,0,0,1000,0
"488",1,"STRONG WIND","VT",0,45000,0,0,45000,0
"489",1,"STRONG WIND","WA",0,693000,4,0,693000,4
"490",1,"STRONG WIND","WI",0,103000,0,0,103000,0
"491",1,"STRONG WIND","WV",0,2200,0,0,2200,0
"492",1,"THUNDERSTORM WIND","AL",34000,5561000,0,4,5595000,4
"493",1,"THUNDERSTORM WIND","AR",0,1680750,0,10,1680750,10
"494",1,"THUNDERSTORM WIND","AZ",0,1831000,0,0,1831000,0
"495",1,"THUNDERSTORM WIND","CA",5000,1123000,1,0,1128000,1
"496",1,"THUNDERSTORM WIND","CT",0,0,0,1,0,1
"497",1,"THUNDERSTORM WIND","FL",0,4448500,0,19,4448500,19
"498",1,"THUNDERSTORM WIND","GA",0,10179300,0,0,10179300,0
"499",1,"THUNDERSTORM WIND","HI",20000,152000,0,0,172000,0
"500",1,"THUNDERSTORM WIND","IA",0,6000,0,0,6000,0
"501",1,"THUNDERSTORM WIND","ID",0,37000,0,0,37000,0
"502",1,"THUNDERSTORM WIND","IL",0,2131000,0,1,2131000,1
"503",1,"THUNDERSTORM WIND","IN",0,3260000,0,1,3260000,1
"504",1,"THUNDERSTORM WIND","KS",0,7500,0,0,7500,0
"505",1,"THUNDERSTORM WIND","KY",1125000,10738500,0,26,11863500,26
"506",1,"THUNDERSTORM WIND","LA",0,2575950,0,21,2575950,21
"507",1,"THUNDERSTORM WIND","MD",0,146500,0,0,146500,0
"508",1,"THUNDERSTORM WIND","MI",0,10500,0,0,10500,0
"509",1,"THUNDERSTORM WIND","MO",0,2800000,0,10,2800000,10
"510",1,"THUNDERSTORM WIND","MS",105000,15234550,0,10,15339550,10
"511",1,"THUNDERSTORM WIND","MT",0,30000,0,0,30000,0
"512",1,"THUNDERSTORM WIND","NC",1001000,6592000,1,8,7593000,9
"513",1,"THUNDERSTORM WIND","NJ",0,30000,0,1,30000,1
"514",1,"THUNDERSTORM WIND","NM",0,105000,0,0,105000,0
"515",1,"THUNDERSTORM WIND","NY",0,534000,0,1,534000,1
"516",1,"THUNDERSTORM WIND","OH",0,3004000,0,2,3004000,2
"517",1,"THUNDERSTORM WIND","OK",0,614810,0,0,614810,0
"518",1,"THUNDERSTORM WIND","OR",0,1500000,1,0,1500000,1
"519",1,"THUNDERSTORM WIND","PA",0,579100,0,1,579100,1
"520",1,"THUNDERSTORM WIND","SC",2000,2802900,0,6,2804900,6
"521",1,"THUNDERSTORM WIND","TN",241000,8919600,2,10,9160600,12
"522",1,"THUNDERSTORM WIND","TX",5000,5500600,0,1,5505600,1
"523",1,"THUNDERSTORM WIND","VA",18000,1011500,0,3,1029500,3
"524",1,"THUNDERSTORM WIND","WA",0,175000,0,0,175000,0
"525",1,"THUNDERSTORM WIND","WV",0,366000,0,0,366000,0
"526",1,"TORNADO","AL",25000,53232280,19,295,53257280,314
"527",1,"TORNADO","AR",0,27344850,13,218,27344850,231
"528",1,"TORNADO","AZ",0,5075000,0,0,5075000,0
"529",1,"TORNADO","CA",0,15840810,0,3,15840810,3
"530",1,"TORNADO","DE",0,250000,0,7,250000,7
"531",1,"TORNADO","FL",10500,51596683,4,228,51607183,232
"532",1,"TORNADO","GA",0,32343780,5,130,32343780,135
"533",1,"TORNADO","HI",0,2775000,0,4,2775000,4
"534",1,"TORNADO","IA",0,1627530,1,11,1627530,12
"535",1,"TORNADO","IL",0,44201030,1,85,44201030,86
"536",1,"TORNADO","IN",50000,1007000,3,7,1057000,10
"537",1,"TORNADO","KS",0,105000,0,0,105000,0
"538",1,"TORNADO","KY",1e+05,82200000,4,39,82300000,43
"539",1,"TORNADO","LA",30000,27384230,9,143,27414230,152
"540",1,"TORNADO","MD",0,25000,0,0,25000,0
"541",1,"TORNADO","MI",0,500,0,0,500,0
"542",1,"TORNADO","MO",0,72272710,8,271,72272710,279
"543",1,"TORNADO","MS",5622000,83731060,42,579,89353060,621
"544",1,"TORNADO","NC",0,4655000,1,50,4655000,51
"545",1,"TORNADO","NE",0,75250,0,0,75250,0
"546",1,"TORNADO","OH",0,625000,0,3,625000,3
"547",1,"TORNADO","OK",0,1255000,10,32,1255000,42
"548",1,"TORNADO","OR",0,3000,0,0,3000,0
"549",1,"TORNADO","PA",0,575000,0,18,575000,18
"550",1,"TORNADO","SC",0,19007000,0,44,19007000,44
"551",1,"TORNADO","TN",0,134341250,14,210,134341250,224
"552",1,"TORNADO","TX",250000,71041000,2,73,71291000,75
"553",1,"TORNADO","UT",0,25000,0,0,25000,0
"554",1,"TORNADO","VA",0,454500,1,14,454500,15
"555",1,"TORNADO","WA",0,625000,0,0,625000,0
"556",1,"TORNADO","WI",0,21990000,0,15,21990000,15
"557",1,"TORNADO","WV",0,275000,0,0,275000,0
"558",1,"TROPICAL STORM","AS",5e+05,5e+05,0,0,1e+06,0
"559",1,"WATERSPOUT","AN",0,5000,0,0,5000,0
"560",1,"WATERSPOUT","FL",0,10000,0,0,10000,0
"561",1,"WILDFIRE","AR",1e+06,870000,0,1,1870000,1
"562",1,"WILDFIRE","CA",0,73050000,0,7,73050000,7
"563",1,"WILDFIRE","CO",0,1e+06,0,0,1e+06,0
"564",1,"WILDFIRE","FL",0,20000,0,1,20000,1
"565",1,"WILDFIRE","GA",0,21150,0,0,21150,0
"566",1,"WILDFIRE","GU",0,70000,0,0,70000,0
"567",1,"WILDFIRE","HI",50000,0,0,3,50000,3
"568",1,"WILDFIRE","NM",10000,7e+05,0,3,710000,3
"569",1,"WILDFIRE","OK",0,1140000,0,1,1140000,1
"570",1,"WILDFIRE","PR",165000,0,0,0,165000,0
"571",1,"WILDFIRE","SC",0,1e+06,0,0,1e+06,0
"572",1,"WILDFIRE","TX",3305000,24485000,0,27,27790000,27
"573",1,"WINTER STORM","AK",0,6000,2,0,6000,2
"574",1,"WINTER STORM","AL",38000,916000,2,2,954000,4
"575",1,"WINTER STORM","AR",0,5210040,1,0,5210040,1
"576",1,"WINTER STORM","AZ",0,1e+05,4,0,1e+05,4
"577",1,"WINTER STORM","CA",10500000,66513000,15,45,77013000,60
"578",1,"WINTER STORM","CO",0,15000,0,0,15000,0
"579",1,"WINTER STORM","CT",0,217000,1,0,217000,1
"580",1,"WINTER STORM","DC",0,0,1,0,0,1
"581",1,"WINTER STORM","DE",0,1100000,0,40,1100000,40
"582",1,"WINTER STORM","GA",0,10780000,0,0,10780000,0
"583",1,"WINTER STORM","IA",0,537000,4,0,537000,4
"584",1,"WINTER STORM","ID",0,27000,1,0,27000,1
"585",1,"WINTER STORM","IL",0,10061000,6,24,10061000,30
"586",1,"WINTER STORM","IN",0,1900000,0,0,1900000,0
"587",1,"WINTER STORM","KS",0,61263000,7,14,61263000,21
"588",1,"WINTER STORM","KY",0,3010000,0,0,3010000,0
"589",1,"WINTER STORM","LA",0,55000,0,4,55000,4
"590",1,"WINTER STORM","MA",0,469000,0,0,469000,0
"591",1,"WINTER STORM","MD",0,44000,2,1,44000,3
"592",1,"WINTER STORM","ME",0,0,1,0,0,1
"593",1,"WINTER STORM","MN",0,80000,1,1,80000,2
"594",1,"WINTER STORM","MO",0,8845020,0,0,8845020,0
"595",1,"WINTER STORM","MS",0,56000,0,0,56000,0
"596",1,"WINTER STORM","MT",0,3000,0,0,3000,0
"597",1,"WINTER STORM","NC",0,750000,2,16,750000,18
"598",1,"WINTER STORM","ND",0,0,2,0,0,2
"599",1,"WINTER STORM","NE",0,606000,7,7,606000,14
"600",1,"WINTER STORM","NH",0,10000,0,0,10000,0
"601",1,"WINTER STORM","NJ",0,18600000,1,25,18600000,26
"602",1,"WINTER STORM","NM",0,0,5,0,0,5
"603",1,"WINTER STORM","NV",0,0,1,6,0,7
"604",1,"WINTER STORM","NY",0,6014300,0,0,6014300,0
"605",1,"WINTER STORM","OH",0,32084000,2,56,32084000,58
"606",1,"WINTER STORM","OK",0,18252000,0,0,18252000,0
"607",1,"WINTER STORM","OR",0,6e+05,5,5,6e+05,10
"608",1,"WINTER STORM","PA",0,20465000,4,152,20465000,156
"609",1,"WINTER STORM","SC",0,225000,0,0,225000,0
"610",1,"WINTER STORM","SD",0,0,0,3,0,3
"611",1,"WINTER STORM","TN",0,1980040,2,0,1980040,2
"612",1,"WINTER STORM","TX",120000,16830000,7,0,16950000,7
"613",1,"WINTER STORM","UT",25000,1302000,6,80,1327000,86
"614",1,"WINTER STORM","VA",25000,373000,2,0,398000,2
"615",1,"WINTER STORM","VT",0,2068650,0,1,2068650,1
"616",1,"WINTER STORM","WA",0,1000,1,0,1000,1
"617",1,"WINTER STORM","WI",0,0,0,6,0,6
"618",1,"WINTER STORM","WV",10000,273000,0,1,283000,1
"619",1,"WINTER WEATHER","AR",0,20000,0,0,20000,0
"620",1,"WINTER WEATHER","CT",0,40000,1,1,40000,2
"621",1,"WINTER WEATHER","DE",0,0,0,10,0,10
"622",1,"WINTER WEATHER","IA",0,65000,0,0,65000,0
"623",1,"WINTER WEATHER","ID",0,0,0,2,0,2
"624",1,"WINTER WEATHER","IL",0,17500,0,0,17500,0
"625",1,"WINTER WEATHER","IN",0,30000,0,0,30000,0
"626",1,"WINTER WEATHER","KS",0,566000,1,8,566000,9
"627",1,"WINTER WEATHER","KY",0,30000,0,0,30000,0
"628",1,"WINTER WEATHER","MA",0,60000,0,0,60000,0
"629",1,"WINTER WEATHER","MD",0,5000,1,0,5000,1
"630",1,"WINTER WEATHER","MI",0,54000,0,0,54000,0
"631",1,"WINTER WEATHER","MS",0,240000,0,0,240000,0
"632",1,"WINTER WEATHER","MT",0,0,1,9,0,10
"633",1,"WINTER WEATHER","ND",0,465000,0,0,465000,0
"634",1,"WINTER WEATHER","NE",0,40000,0,0,40000,0
"635",1,"WINTER WEATHER","NJ",0,0,2,8,0,10
"636",1,"WINTER WEATHER","NV",0,125000,0,0,125000,0
"637",1,"WINTER WEATHER","NY",0,671000,0,0,671000,0
"638",1,"WINTER WEATHER","OK",0,25000,0,0,25000,0
"639",1,"WINTER WEATHER","OR",0,50000,0,1,50000,1
"640",1,"WINTER WEATHER","PA",0,1790000,6,23,1790000,29
"641",1,"WINTER WEATHER","SC",0,110000,7,0,110000,7
"642",1,"WINTER WEATHER","SD",0,0,1,0,0,1
"643",1,"WINTER WEATHER","TN",0,290000,0,0,290000,0
"644",1,"WINTER WEATHER","TX",0,5485000,2,2,5485000,4
"645",1,"WINTER WEATHER","UT",0,20000,0,0,20000,0
"646",1,"WINTER WEATHER","VA",0,10000,2,0,10000,2
"647",1,"WINTER WEATHER","VT",0,766000,0,0,766000,0
"648",1,"WINTER WEATHER","WA",0,0,0,2,0,2
"649",1,"WINTER WEATHER","WI",0,6000,2,0,6000,2
"650",2,"AVALANCHE","AK",0,250000,6,5,250000,11
"651",2,"AVALANCHE","CA",0,55000,2,4,55000,6
"652",2,"AVALANCHE","CO",0,6000,10,8,6000,18
"653",2,"AVALANCHE","ID",0,20000,4,3,20000,7
"654",2,"AVALANCHE","MT",0,0,0,1,0,1
"655",2,"AVALANCHE","NV",0,0,0,1,0,1
"656",2,"AVALANCHE","NY",0,0,1,5,0,6
"657",2,"AVALANCHE","UT",0,0,6,3,0,9
"658",2,"AVALANCHE","WA",0,1100000,5,5,1100000,10
"659",2,"AVALANCHE","WY",0,0,7,6,0,13
"660",2,"BLIZZARD","AK",0,2e+05,3,2,2e+05,5
"661",2,"BLIZZARD","CA",0,20000,0,0,20000,0
"662",2,"BLIZZARD","IA",0,375000,1,0,375000,1
"663",2,"BLIZZARD","IL",0,1455000,0,0,1455000,0
"664",2,"BLIZZARD","IN",0,1e+05,0,0,1e+05,0
"665",2,"BLIZZARD","MA",0,15000,0,0,15000,0
"666",2,"BLIZZARD","MI",0,250000,0,0,250000,0
"667",2,"BLIZZARD","MT",0,50000,2,5,50000,7
"668",2,"BLIZZARD","ND",0,2e+05,0,5,2e+05,5
"669",2,"BLIZZARD","NE",0,40000,0,1,40000,1
"670",2,"BLIZZARD","RI",0,10000,0,0,10000,0
"671",2,"COASTAL FLOOD","AK",0,10000,0,0,10000,0
"672",2,"COASTAL FLOOD","DE",0,1700000,0,5,1700000,5
"673",2,"COASTAL FLOOD","MA",0,50000,0,0,50000,0
"674",2,"COASTAL FLOOD","MD",0,2150000,0,0,2150000,0
"675",2,"COASTAL FLOOD","ME",0,4000,0,0,4000,0
"676",2,"COASTAL FLOOD","NH",0,6000,0,0,6000,0
"677",2,"COASTAL FLOOD","NJ",0,17930000,0,0,17930000,0
"678",2,"COASTAL FLOOD","NY",0,750000,0,0,750000,0
"679",2,"COASTAL FLOOD","PR",0,40000,0,0,40000,0
"680",2,"COASTAL FLOOD","VA",0,75003000,0,0,75003000,0
"681",2,"COASTAL FLOOD","WA",0,5e+05,0,0,5e+05,0
"682",2,"COLD/WIND CHILL","AK",0,250000,1,1,250000,2
"683",2,"COLD/WIND CHILL","AL",0,0,2,0,0,2
"684",2,"COLD/WIND CHILL","AR",0,0,1,0,0,1
"685",2,"COLD/WIND CHILL","AZ",0,0,2,1,0,3
"686",2,"COLD/WIND CHILL","CA",0,0,2,12,0,14
"687",2,"COLD/WIND CHILL","FL",74900000,0,1,0,74900000,1
"688",2,"COLD/WIND CHILL","IA",0,0,1,0,0,1
"689",2,"COLD/WIND CHILL","IL",0,0,12,0,0,12
"690",2,"COLD/WIND CHILL","IN",0,160000,3,0,160000,3
"691",2,"COLD/WIND CHILL","KS",0,0,1,0,0,1
"692",2,"COLD/WIND CHILL","KY",0,275000,1,0,275000,1
"693",2,"COLD/WIND CHILL","LA",2e+07,650000,1,0,20650000,1
"694",2,"COLD/WIND CHILL","MD",0,0,1,0,0,1
"695",2,"COLD/WIND CHILL","MI",0,175000,2,10,175000,12
"696",2,"COLD/WIND CHILL","MS",0,1e+05,3,0,1e+05,3
"697",2,"COLD/WIND CHILL","MT",0,1400,0,0,1400,0
"698",2,"COLD/WIND CHILL","NC",0,275000,3,0,275000,3
"699",2,"COLD/WIND CHILL","ND",0,0,1,0,0,1
"700",2,"COLD/WIND CHILL","NE",0,0,0,1,0,1
"701",2,"COLD/WIND CHILL","NH",0,0,3,0,0,3
"702",2,"COLD/WIND CHILL","NM",0,0,1,0,0,1
"703",2,"COLD/WIND CHILL","NY",0,5550000,0,0,5550000,0
"704",2,"COLD/WIND CHILL","OH",0,4870000,5,0,4870000,5
"705",2,"COLD/WIND CHILL","PA",0,350000,3,0,350000,3
"706",2,"COLD/WIND CHILL","SC",0,0,4,0,0,4
"707",2,"COLD/WIND CHILL","TN",0,0,2,0,0,2
"708",2,"COLD/WIND CHILL","TX",1200000,50000,1,0,1250000,1
"709",2,"COLD/WIND CHILL","VA",0,25000,1,0,25000,1
"710",2,"COLD/WIND CHILL","VT",0,5e+05,0,0,5e+05,0
"711",2,"COLD/WIND CHILL","WI",0,1000,7,18,1000,25
"712",2,"COLD/WIND CHILL","WV",0,1e+05,0,0,1e+05,0
"713",2,"COLD/WIND CHILL","WY",0,50000,1,0,50000,1
"714",2,"DEBRIS FLOW","AK",0,1600000,0,0,1600000,0
"715",2,"DEBRIS FLOW","AS",0,15000,0,0,15000,0
"716",2,"DEBRIS FLOW","CA",0,5908000,1,0,5908000,1
"717",2,"DEBRIS FLOW","GU",0,1000,0,0,1000,0
"718",2,"DEBRIS FLOW","NC",0,1e+05,0,0,1e+05,0
"719",2,"DEBRIS FLOW","OR",0,0,1,0,0,1
"720",2,"DEBRIS FLOW","UT",0,25000,0,0,25000,0
"721",2,"DEBRIS FLOW","WA",0,2e+05,0,0,2e+05,0
"722",2,"DENSE FOG","CA",0,1310000,8,98,1310000,106
"723",2,"DENSE FOG","FL",0,350000,2,7,350000,9
"724",2,"DENSE FOG","IA",0,12000,0,0,12000,0
"725",2,"DENSE FOG","ID",0,50000,0,0,50000,0
"726",2,"DENSE FOG","IN",0,50000,0,0,50000,0
"727",2,"DENSE FOG","KS",0,50000,0,0,50000,0
"728",2,"DENSE FOG","MN",0,5000,0,0,5000,0
"729",2,"DENSE FOG","NY",0,0,1,10,0,11
"730",2,"DENSE FOG","OH",0,250000,1,14,250000,15
"731",2,"DENSE FOG","PA",0,0,0,1,0,1
"732",2,"DENSE FOG","TX",0,75000,0,4,75000,4
"733",2,"DENSE FOG","UT",0,532000,3,15,532000,18
"734",2,"DENSE FOG","VT",0,45000,0,0,45000,0
"735",2,"DENSE FOG","WI",0,20000,0,0,20000,0
"736",2,"DENSE FOG","WY",0,32000,0,5,32000,5
"737",2,"DROUGHT","CA",0,50000,0,0,50000,0
"738",2,"DROUGHT","HI",1e+05,0,0,0,1e+05,0
"739",2,"DROUGHT","OK",1e+06,25000,0,0,1025000,0
"740",2,"DROUGHT","TX",312047000,6e+06,0,0,318047000,0
"741",2,"DUST DEVIL","NC",0,10000,0,0,10000,0
"742",2,"DUST DEVIL","NV",0,5000,0,0,5000,0
"743",2,"DUST DEVIL","WA",0,1000,0,0,1000,0
"744",2,"DUST STORM","AZ",0,0,2,13,0,15
"745",2,"DUST STORM","CA",1e+05,205000,0,31,305000,31
"746",2,"DUST STORM","OK",0,20000,0,0,20000,0
"747",2,"DUST STORM","TX",0,25000,0,0,25000,0
"748",2,"EXTREME COLD/WIND CHILL","AZ",0,30000,0,0,30000,0
"749",2,"EXTREME COLD/WIND CHILL","CA",0,0,0,2,0,2
"750",2,"EXTREME COLD/WIND CHILL","DE",0,0,1,1,0,2
"751",2,"EXTREME COLD/WIND CHILL","IA",0,50000,0,0,50000,0
"752",2,"EXTREME COLD/WIND CHILL","IL",0,0,18,0,0,18
"753",2,"EXTREME COLD/WIND CHILL","MA",0,0,1,0,0,1
"754",2,"EXTREME COLD/WIND CHILL","MD",0,0,1,0,0,1
"755",2,"EXTREME COLD/WIND CHILL","MI",0,0,1,0,0,1
"756",2,"EXTREME COLD/WIND CHILL","MT",0,0,2,0,0,2
"757",2,"EXTREME COLD/WIND CHILL","ND",0,0,2,0,0,2
"758",2,"EXTREME COLD/WIND CHILL","NJ",0,0,1,0,0,1
"759",2,"EXTREME COLD/WIND CHILL","NM",0,925000,0,0,925000,0
"760",2,"EXTREME COLD/WIND CHILL","NY",0,0,3,0,0,3
"761",2,"EXTREME COLD/WIND CHILL","OH",0,0,1,0,0,1
"762",2,"EXTREME COLD/WIND CHILL","TX",0,5050000,0,0,5050000,0
"763",2,"EXTREME COLD/WIND CHILL","WI",0,3000,2,0,3000,2
"764",2,"FLASH FLOOD","AK",0,1000,0,0,1000,0
"765",2,"FLASH FLOOD","AL",55000,5650000,1,2,5705000,3
"766",2,"FLASH FLOOD","AR",0,429000,1,0,429000,1
"767",2,"FLASH FLOOD","AS",2000,9000,0,0,11000,0
"768",2,"FLASH FLOOD","AZ",0,6e+05,0,0,6e+05,0
"769",2,"FLASH FLOOD","CA",8159000,3.2e+07,2,3,40159000,5
"770",2,"FLASH FLOOD","FL",0,2105000,0,1,2105000,1
"771",2,"FLASH FLOOD","HI",0,25000,0,0,25000,0
"772",2,"FLASH FLOOD","IA",0,330000,1,0,330000,1
"773",2,"FLASH FLOOD","ID",0,926500,0,0,926500,0
"774",2,"FLASH FLOOD","IL",0,1670000,0,0,1670000,0
"775",2,"FLASH FLOOD","IN",0,572000,0,0,572000,0
"776",2,"FLASH FLOOD","KS",0,0,1,0,0,1
"777",2,"FLASH FLOOD","KY",0,14330000,6,2,14330000,8
"778",2,"FLASH FLOOD","LA",0,421000,0,0,421000,0
"779",2,"FLASH FLOOD","MI",0,755000,0,0,755000,0
"780",2,"FLASH FLOOD","MO",0,6e+05,2,1,6e+05,3
"781",2,"FLASH FLOOD","MS",0,21581000,0,0,21581000,0
"782",2,"FLASH FLOOD","MT",0,50000,0,0,50000,0
"783",2,"FLASH FLOOD","NC",0,4e+05,0,0,4e+05,0
"784",2,"FLASH FLOOD","NM",0,1e+05,0,0,1e+05,0
"785",2,"FLASH FLOOD","NV",0,35000,0,0,35000,0
"786",2,"FLASH FLOOD","NY",0,5733000,0,0,5733000,0
"787",2,"FLASH FLOOD","OH",0,7614000,1,0,7614000,1
"788",2,"FLASH FLOOD","OK",0,30000,1,0,30000,1
"789",2,"FLASH FLOOD","PA",0,168000,0,0,168000,0
"790",2,"FLASH FLOOD","PR",0,115000,1,0,115000,1
"791",2,"FLASH FLOOD","RI",0,4e+05,0,0,4e+05,0
"792",2,"FLASH FLOOD","SC",0,57000,0,0,57000,0
"793",2,"FLASH FLOOD","TN",7000,406500,0,1,413500,1
"794",2,"FLASH FLOOD","TX",43000,5431000,2,2,5474000,4
"795",2,"FLASH FLOOD","UT",0,50000,0,0,50000,0
"796",2,"FLASH FLOOD","VA",0,1430000,0,0,1430000,0
"797",2,"FLASH FLOOD","WV",0,6352000,4,0,6352000,4
"798",2,"FLOOD","AK",0,1600000,0,0,1600000,0
"799",2,"FLOOD","AL",0,93000,0,0,93000,0
"800",2,"FLOOD","AR",0,15000,0,0,15000,0
"801",2,"FLOOD","AS",0,4e+05,0,0,4e+05,0
"802",2,"FLOOD","AZ",5500000,3015500,0,0,8515500,0
"803",2,"FLOOD","CA",42027000,157570500,21,16,199597500,37
"804",2,"FLOOD","CT",0,41000,0,0,41000,0
"805",2,"FLOOD","FL",1075000,4032000,0,0,5107000,0
"806",2,"FLOOD","GA",14000,657000,0,0,671000,0
"807",2,"FLOOD","IA",0,1821000,0,0,1821000,0
"808",2,"FLOOD","ID",0,45800000,0,1,45800000,1
"809",2,"FLOOD","IL",0,3349000,1,0,3349000,1
"810",2,"FLOOD","IN",0,6240000,1,6,6240000,7
"811",2,"FLOOD","KS",50000,50000,0,0,1e+05,0
"812",2,"FLOOD","KY",10000,22375000,0,0,22385000,0
"813",2,"FLOOD","LA",0,1717000,0,0,1717000,0
"814",2,"FLOOD","MA",0,70000,0,0,70000,0
"815",2,"FLOOD","MD",0,145000,0,0,145000,0
"816",2,"FLOOD","ME",0,1789000,0,0,1789000,0
"817",2,"FLOOD","MI",0,4195000,3,0,4195000,3
"818",2,"FLOOD","MO",0,105000,0,4,105000,4
"819",2,"FLOOD","MS",0,351000,0,0,351000,0
"820",2,"FLOOD","MT",0,793400,0,0,793400,0
"821",2,"FLOOD","ND",0,4e+05,0,0,4e+05,0
"822",2,"FLOOD","NE",0,1387000,0,0,1387000,0
"823",2,"FLOOD","NH",0,7387100,0,0,7387100,0
"824",2,"FLOOD","NM",0,1050000,0,0,1050000,0
"825",2,"FLOOD","NV",0,15000,0,0,15000,0
"826",2,"FLOOD","NY",0,858000,0,0,858000,0
"827",2,"FLOOD","OH",0,17423000,3,2,17423000,5
"828",2,"FLOOD","OR",0,400100000,7,0,400100000,7
"829",2,"FLOOD","PA",0,6003000,0,0,6003000,0
"830",2,"FLOOD","PR",0,20000,0,0,20000,0
"831",2,"FLOOD","RI",0,50000,0,0,50000,0
"832",2,"FLOOD","SC",0,506000,0,0,506000,0
"833",2,"FLOOD","SD",0,10000,0,0,10000,0
"834",2,"FLOOD","TN",0,26449500,2,0,26449500,2
"835",2,"FLOOD","TX",1e+05,4055000,2,0,4155000,2
"836",2,"FLOOD","VA",0,5805000,3,1,5805000,4
"837",2,"FLOOD","VT",0,36000,0,0,36000,0
"838",2,"FLOOD","WA",0,845000,0,0,845000,0
"839",2,"FLOOD","WI",25000,468500,2,0,493500,2
"840",2,"FLOOD","WV",0,17346000,2,0,17346000,2
"841",2,"FLOOD","WY",0,25000,0,0,25000,0
"842",2,"FREEZING FOG","NY",0,5000,0,0,5000,0
"843",2,"FREEZING FOG","SD",0,20000,0,0,20000,0
"844",2,"FREEZING FOG","VT",0,15000,0,0,15000,0
"845",2,"FROST/FREEZE","AL",0,10000,0,0,10000,0
"846",2,"FROST/FREEZE","AZ",3e+05,2e+06,0,0,2300000,0
"847",2,"FROST/FREEZE","CA",12052000,0,0,0,12052000,0
"848",2,"FROST/FREEZE","FL",87130000,0,0,0,87130000,0
"849",2,"FROST/FREEZE","IA",0,55500,1,0,55500,1
"850",2,"FROST/FREEZE","NV",0,2e+06,0,0,2e+06,0
"851",2,"FROST/FREEZE","PA",0,0,2,0,0,2
"852",2,"FROST/FREEZE","TX",1e+07,0,0,0,1e+07,0
"853",2,"FROST/FREEZE","WA",20000,50000,0,5,70000,5
"854",2,"HAIL","AL",0,148000,0,0,148000,0
"855",2,"HAIL","AR",0,1655620,0,0,1655620,0
"856",2,"HAIL","AZ",0,3000,0,0,3000,0
"857",2,"HAIL","CA",170000,30000,1,6,2e+05,7
"858",2,"HAIL","FL",0,257600,0,2,257600,2
"859",2,"HAIL","GA",0,59136200,0,0,59136200,0
"860",2,"HAIL","IA",0,14500,0,0,14500,0
"861",2,"HAIL","ID",0,10000,0,0,10000,0
"862",2,"HAIL","IL",0,415000,0,0,415000,0
"863",2,"HAIL","KS",3000,8000,0,0,11000,0
"864",2,"HAIL","KY",0,128000,0,0,128000,0
"865",2,"HAIL","LA",0,1435000,0,2,1435000,2
"866",2,"HAIL","MO",0,7734850,0,1,7734850,1
"867",2,"HAIL","MS",0,3291400,0,0,3291400,0
"868",2,"HAIL","NC",0,10000,0,0,10000,0
"869",2,"HAIL","NM",0,3000,0,3,3000,3
"870",2,"HAIL","OH",0,36000,0,0,36000,0
"871",2,"HAIL","OK",0,226500,0,0,226500,0
"872",2,"HAIL","SC",0,55000,0,0,55000,0
"873",2,"HAIL","TN",0,112690,0,0,112690,0
"874",2,"HAIL","TX",358500,31138000,0,0,31496500,0
"875",2,"HAIL","VA",0,2000,0,0,2000,0
"876",2,"HAIL","WV",0,15000,0,0,15000,0
"877",2,"HEAT","FL",0,0,1,0,0,1
"878",2,"HEAVY RAIN","AL",0,5e+05,0,4,5e+05,4
"879",2,"HEAVY RAIN","AS",10000,50000,0,0,60000,0
"880",2,"HEAVY RAIN","AZ",0,0,1,3,0,4
"881",2,"HEAVY RAIN","CA",11100000,136409000,5,37,147509000,42
"882",2,"HEAVY RAIN","FL",0,60000,0,0,60000,0
"883",2,"HEAVY RAIN","GA",0,65500,0,1,65500,1
"884",2,"HEAVY RAIN","IL",0,50000,0,0,50000,0
"885",2,"HEAVY RAIN","MO",0,0,1,0,0,1
"886",2,"HEAVY RAIN","NC",0,20000,0,0,20000,0
"887",2,"HEAVY RAIN","NJ",0,2e+06,0,0,2e+06,0
"888",2,"HEAVY RAIN","NV",0,20000,0,0,20000,0
"889",2,"HEAVY RAIN","NY",0,1108000,0,0,1108000,0
"890",2,"HEAVY RAIN","OR",0,4000,0,0,4000,0
"891",2,"HEAVY RAIN","RI",0,30000,0,0,30000,0
"892",2,"HEAVY RAIN","SC",0,1000,0,0,1000,0
"893",2,"HEAVY RAIN","TX",0,5000,1,0,5000,1
"894",2,"HEAVY RAIN","VT",0,785000,0,0,785000,0
"895",2,"HEAVY RAIN","WA",0,135000,0,0,135000,0
"896",2,"HEAVY RAIN","WV",0,85000,6,0,85000,6
"897",2,"HEAVY SNOW","AK",0,141000,0,0,141000,0
"898",2,"HEAVY SNOW","AR",0,50319000,0,0,50319000,0
"899",2,"HEAVY SNOW","AZ",0,50000,0,4,50000,4
"900",2,"HEAVY SNOW","CA",0,475000,1,0,475000,1
"901",2,"HEAVY SNOW","CO",0,200001.7,4,6,200001.7,10
"902",2,"HEAVY SNOW","CT",0,50000,0,0,50000,0
"903",2,"HEAVY SNOW","DC",0,35000,0,0,35000,0
"904",2,"HEAVY SNOW","GA",0,5000,0,1,5000,1
"905",2,"HEAVY SNOW","IA",0,1125500,0,0,1125500,0
"906",2,"HEAVY SNOW","ID",0,120000,0,4,120000,4
"907",2,"HEAVY SNOW","IL",0,5050000,0,0,5050000,0
"908",2,"HEAVY SNOW","IN",0,150000,0,0,150000,0
"909",2,"HEAVY SNOW","KS",0,141000,0,0,141000,0
"910",2,"HEAVY SNOW","KY",0,10900000,5,5,10900000,10
"911",2,"HEAVY SNOW","LA",0,3e+05,0,0,3e+05,0
"912",2,"HEAVY SNOW","MA",0,113000,0,0,113000,0
"913",2,"HEAVY SNOW","MD",0,240000,0,0,240000,0
"914",2,"HEAVY SNOW","MI",0,0,1,0,0,1
"915",2,"HEAVY SNOW","MO",0,1006000,0,0,1006000,0
"916",2,"HEAVY SNOW","MS",0,2563700,0,0,2563700,0
"917",2,"HEAVY SNOW","MT",0,1e+05,1,0,1e+05,1
"918",2,"HEAVY SNOW","NC",0,3155000,0,0,3155000,0
"919",2,"HEAVY SNOW","ND",0,0,1,13,0,14
"920",2,"HEAVY SNOW","NH",0,80000,0,1,80000,1
"921",2,"HEAVY SNOW","NJ",0,8e+06,1,8,8e+06,9
"922",2,"HEAVY SNOW","NM",0,20000,0,0,20000,0
"923",2,"HEAVY SNOW","NV",0,50000,0,0,50000,0
"924",2,"HEAVY SNOW","NY",0,29022010,1,0,29022010,1
"925",2,"HEAVY SNOW","OH",0,14610000,1,0,14610000,1
"926",2,"HEAVY SNOW","OR",0,55000,1,4,55000,5
"927",2,"HEAVY SNOW","PA",0,9655000,0,2,9655000,2
"928",2,"HEAVY SNOW","SC",0,1890000,0,0,1890000,0
"929",2,"HEAVY SNOW","SD",0,120000,1,0,120000,1
"930",2,"HEAVY SNOW","TN",0,5049700,0,0,5049700,0
"931",2,"HEAVY SNOW","TX",0,24655000,0,0,24655000,0
"932",2,"HEAVY SNOW","UT",30500,1122000,4,67,1152500,71
"933",2,"HEAVY SNOW","VA",5000,275000,1,0,280000,1
"934",2,"HEAVY SNOW","VT",0,2213000,0,0,2213000,0
"935",2,"HEAVY SNOW","WA",0,736000,1,17,736000,18
"936",2,"HEAVY SNOW","WV",0,2498000,0,1,2498000,1
"937",2,"HIGH SURF","AS",0,10000,0,2,10000,2
"938",2,"HIGH SURF","CA",0,80000,4,17,80000,21
"939",2,"HIGH SURF","DE",0,1e+06,0,0,1e+06,0
"940",2,"HIGH SURF","GU",0,0,1,0,0,1
"941",2,"HIGH SURF","HI",0,730000,4,1,730000,5
"942",2,"HIGH SURF","ME",0,15000,0,0,15000,0
"943",2,"HIGH SURF","NH",0,20000,0,0,20000,0
"944",2,"HIGH SURF","NJ",0,5e+06,0,0,5e+06,0
"945",2,"HIGH SURF","OR",0,0,1,0,0,1
"946",2,"HIGH SURF","PR",0,0,1,0,0,1
"947",2,"HIGH SURF","VI",0,15000,0,0,15000,0
"948",2,"HIGH SURF","WA",0,0,3,0,0,3
"949",2,"HIGH WIND","AK",0,1341500,0,0,1341500,0
"950",2,"HIGH WIND","AL",0,181000,0,0,181000,0
"951",2,"HIGH WIND","AR",0,50000,0,0,50000,0
"952",2,"HIGH WIND","AS",6000,27000,0,0,33000,0
"953",2,"HIGH WIND","AZ",0,163000,0,0,163000,0
"954",2,"HIGH WIND","CA",7875000,15367000,5,13,23242000,18
"955",2,"HIGH WIND","CO",5000,4746500,1,11,4751500,12
"956",2,"HIGH WIND","CT",0,631000,2,3,631000,5
"957",2,"HIGH WIND","DC",0,6000,0,0,6000,0
"958",2,"HIGH WIND","DE",0,135000,0,0,135000,0
"959",2,"HIGH WIND","FL",0,612000,1,4,612000,5
"960",2,"HIGH WIND","GA",0,54000,1,1,54000,2
"961",2,"HIGH WIND","HI",2e+06,2140000,0,0,4140000,0
"962",2,"HIGH WIND","IA",0,767000,0,1,767000,1
"963",2,"HIGH WIND","ID",0,3105000,0,0,3105000,0
"964",2,"HIGH WIND","IL",0,3006000,0,0,3006000,0
"965",2,"HIGH WIND","IN",0,138500,0,0,138500,0
"966",2,"HIGH WIND","KS",0,408500,2,2,408500,4
"967",2,"HIGH WIND","KY",0,208500,0,0,208500,0
"968",2,"HIGH WIND","LA",0,230000,1,1,230000,2
"969",2,"HIGH WIND","MA",0,2663500,1,4,2663500,5
"970",2,"HIGH WIND","MD",2e+05,731000,0,1,931000,1
"971",2,"HIGH WIND","ME",0,175000,0,0,175000,0
"972",2,"HIGH WIND","MI",0,118000,0,1,118000,1
"973",2,"HIGH WIND","MN",0,105000,0,1,105000,1
"974",2,"HIGH WIND","MO",0,135000,0,0,135000,0
"975",2,"HIGH WIND","MS",0,227000,0,0,227000,0
"976",2,"HIGH WIND","MT",0,162000,0,0,162000,0
"977",2,"HIGH WIND","NC",0,489030,1,0,489030,1
"978",2,"HIGH WIND","NE",0,152000,0,0,152000,0
"979",2,"HIGH WIND","NH",0,4668000,0,0,4668000,0
"980",2,"HIGH WIND","NJ",0,815000,0,0,815000,0
"981",2,"HIGH WIND","NM",0,360000,1,2,360000,3
"982",2,"HIGH WIND","NV",1e+05,1069000,0,1,1169000,1
"983",2,"HIGH WIND","NY",0,20784000,3,15,20784000,18
"984",2,"HIGH WIND","OH",0,8803000,1,2,8803000,3
"985",2,"HIGH WIND","OK",0,358600,0,0,358600,0
"986",2,"HIGH WIND","OR",0,6610000,1,4,6610000,5
"987",2,"HIGH WIND","PA",0,4859850,0,1,4859850,1
"988",2,"HIGH WIND","PR",0,56000,0,0,56000,0
"989",2,"HIGH WIND","RI",0,30000,0,0,30000,0
"990",2,"HIGH WIND","SC",0,102970,1,0,102970,1
"991",2,"HIGH WIND","SD",0,835000,0,0,835000,0
"992",2,"HIGH WIND","TN",0,239000,0,0,239000,0
"993",2,"HIGH WIND","TX",0,1069000,0,4,1069000,4
"994",2,"HIGH WIND","UT",18000,4624000,1,3,4642000,4
"995",2,"HIGH WIND","VA",1000,875000,0,2,876000,2
"996",2,"HIGH WIND","VT",0,1225000,0,3,1225000,3
"997",2,"HIGH WIND","WA",0,12751000,0,2,12751000,2
"998",2,"HIGH WIND","WI",0,82000,0,0,82000,0
"999",2,"HIGH WIND","WV",0,1359000,0,0,1359000,0
"1000",2,"HIGH WIND","WY",0,564000,1,5,564000,6
"1001",2,"HURRICANE/TYPHOON","AS",102000,10050000,0,0,10152000,0
"1002",2,"ICE STORM","AR",0,5230000,1,0,5230000,1
"1003",2,"ICE STORM","CT",0,0,1,0,0,1
"1004",2,"ICE STORM","GA",0,50000,0,0,50000,0
"1005",2,"ICE STORM","IA",0,12649000,0,0,12649000,0
"1006",2,"ICE STORM","IL",0,1404000,0,1,1404000,1
"1007",2,"ICE STORM","IN",0,1250000,0,0,1250000,0
"1008",2,"ICE STORM","KS",0,1e+05,3,2,1e+05,5
"1009",2,"ICE STORM","KY",0,28895000,1,0,28895000,1
"1010",2,"ICE STORM","LA",0,52605000,1,0,52605000,1
"1011",2,"ICE STORM","MA",0,0,0,1,0,1
"1012",2,"ICE STORM","MD",0,5000,0,0,5000,0
"1013",2,"ICE STORM","ME",0,3e+05,0,0,3e+05,0
"1014",2,"ICE STORM","MI",25000,3782000,0,0,3807000,0
"1015",2,"ICE STORM","MO",0,25000,0,15,25000,15
"1016",2,"ICE STORM","MS",5e+09,6495000,0,0,5006495000,0
"1017",2,"ICE STORM","NC",0,60895000,0,0,60895000,0
"1018",2,"ICE STORM","NE",0,28000,2,1,28000,3
"1019",2,"ICE STORM","NH",0,20000,0,0,20000,0
"1020",2,"ICE STORM","NM",0,50000,0,0,50000,0
"1021",2,"ICE STORM","NY",0,3e+05,0,0,3e+05,0
"1022",2,"ICE STORM","OH",6e+06,66855000,1,1600,72855000,1601
"1023",2,"ICE STORM","OR",0,0,1,0,0,1
"1024",2,"ICE STORM","PA",0,10000,0,0,10000,0
"1025",2,"ICE STORM","SC",0,5080000,1,24,5080000,25
"1026",2,"ICE STORM","TN",0,5e+05,0,0,5e+05,0
"1027",2,"ICE STORM","TX",450000,52065000,1,1,52515000,2
"1028",2,"ICE STORM","VA",1200000,547000,0,0,1747000,0
"1029",2,"ICE STORM","WI",0,20000,0,1,20000,1
"1030",2,"ICE STORM","WV",0,10100000,0,0,10100000,0
"1031",2,"ICE STORM","WY",0,21000,0,0,21000,0
"1032",2,"LAKE-EFFECT SNOW","NY",0,3363000,0,0,3363000,0
"1033",2,"LAKE-EFFECT SNOW","OH",0,325000,0,0,325000,0
"1034",2,"LAKE-EFFECT SNOW","PA",0,440000,0,0,440000,0
"1035",2,"LIGHTNING","AL",0,583000,0,3,583000,3
"1036",2,"LIGHTNING","AR",0,180500,1,2,180500,3
"1037",2,"LIGHTNING","AZ",0,50000,0,5,50000,5
"1038",2,"LIGHTNING","CA",0,65000,0,1,65000,1
"1039",2,"LIGHTNING","CO",0,1000,0,0,1000,0
"1040",2,"LIGHTNING","CT",0,0,0,1,0,1
"1041",2,"LIGHTNING","FL",0,851000,1,12,851000,13
"1042",2,"LIGHTNING","GA",0,2578500,0,53,2578500,53
"1043",2,"LIGHTNING","GU",0,1e+05,0,0,1e+05,0
"1044",2,"LIGHTNING","IA",0,9000,0,1,9000,1
"1045",2,"LIGHTNING","ID",0,5000,0,0,5000,0
"1046",2,"LIGHTNING","IL",0,180000,1,1,180000,2
"1047",2,"LIGHTNING","IN",0,220000,0,1,220000,1
"1048",2,"LIGHTNING","KS",0,116000,0,0,116000,0
"1049",2,"LIGHTNING","LA",15000,40000,1,1,55000,2
"1050",2,"LIGHTNING","MD",0,5000,0,0,5000,0
"1051",2,"LIGHTNING","ME",0,0,0,14,0,14
"1052",2,"LIGHTNING","MO",0,5000,0,0,5000,0
"1053",2,"LIGHTNING","MS",0,35000,0,0,35000,0
"1054",2,"LIGHTNING","NC",0,173000,0,3,173000,3
"1055",2,"LIGHTNING","NJ",0,1000,0,0,1000,0
"1056",2,"LIGHTNING","NM",0,4000,0,0,4000,0
"1057",2,"LIGHTNING","NY",0,259000,0,0,259000,0
"1058",2,"LIGHTNING","OH",0,201000,1,0,201000,1
"1059",2,"LIGHTNING","OK",0,277700,0,0,277700,0
"1060",2,"LIGHTNING","PA",0,5000,0,0,5000,0
"1061",2,"LIGHTNING","RI",0,8000,0,0,8000,0
"1062",2,"LIGHTNING","SC",0,344000,0,0,344000,0
"1063",2,"LIGHTNING","TN",0,325000,0,2,325000,2
"1064",2,"LIGHTNING","TX",0,1554000,4,3,1554000,7
"1065",2,"LIGHTNING","VT",0,413000,0,0,413000,0
"1066",2,"LIGHTNING","WA",0,2300,0,0,2300,0
"1067",2,"LIGHTNING","WI",0,31000,0,0,31000,0
"1068",2,"MARINE STRONG WIND","PH",0,0,1,0,0,1
"1069",2,"MARINE STRONG WIND","PZ",0,20000,1,2,20000,3
"1070",2,"MARINE THUNDERSTORM WIND","AM",0,5e+05,0,1,5e+05,1
"1071",2,"MARINE THUNDERSTORM WIND","GM",0,3000,0,0,3000,0
"1072",2,"OTHER EVENT NON IDENTIFIED","AK",0,50000,0,0,50000,0
"1073",2,"OTHER EVENT NON IDENTIFIED","MO",0,50000,0,0,50000,0
"1074",2,"OTHER EVENT NON IDENTIFIED","TX",0,6e+05,6,4,6e+05,10
"1075",2,"OTHER EVENT NON IDENTIFIED","WV",0,5000,0,0,5000,0
"1076",2,"RIP CURRENT","AS",0,0,3,0,0,3
"1077",2,"RIP CURRENT","CA",0,0,2,13,0,15
"1078",2,"RIP CURRENT","FL",0,0,2,2,0,4
"1079",2,"RIP CURRENT","GU",0,0,6,12,0,18
"1080",2,"RIP CURRENT","PR",0,0,1,0,0,1
"1081",2,"SEICHE","AK",0,750000,0,0,750000,0
"1082",2,"SLEET","AZ",0,0,2,0,0,2
"1083",2,"STORM SURGE/TIDE","CA",0,10000,0,0,10000,0
"1084",2,"STORM SURGE/TIDE","MA",0,80000,0,0,80000,0
"1085",2,"STORM SURGE/TIDE","ME",0,72000,0,0,72000,0
"1086",2,"STORM SURGE/TIDE","MS",0,1e+06,0,0,1e+06,0
"1087",2,"STORM SURGE/TIDE","OH",0,925000,0,0,925000,0
"1088",2,"STORM SURGE/TIDE","OR",0,5e+05,0,0,5e+05,0
"1089",2,"STRONG WIND","AL",0,47000,0,0,47000,0
"1090",2,"STRONG WIND","AR",0,267000,0,0,267000,0
"1091",2,"STRONG WIND","AS",10000,1000,0,0,11000,0
"1092",2,"STRONG WIND","AZ",0,88000,0,2,88000,2
"1093",2,"STRONG WIND","CA",175500,992900,1,1,1168400,2
"1094",2,"STRONG WIND","CO",0,60000,0,0,60000,0
"1095",2,"STRONG WIND","CT",0,15000,0,0,15000,0
"1096",2,"STRONG WIND","DC",0,13100,0,0,13100,0
"1097",2,"STRONG WIND","DE",0,165250,0,0,165250,0
"1098",2,"STRONG WIND","GA",0,445000,0,1,445000,1
"1099",2,"STRONG WIND","HI",0,5000,1,1,5000,2
"1100",2,"STRONG WIND","ID",0,13000,0,0,13000,0
"1101",2,"STRONG WIND","IL",0,43000,0,0,43000,0
"1102",2,"STRONG WIND","IN",0,10000,0,0,10000,0
"1103",2,"STRONG WIND","KS",0,13000,0,0,13000,0
"1104",2,"STRONG WIND","KY",0,208000,0,0,208000,0
"1105",2,"STRONG WIND","LA",0,5000,0,0,5000,0
"1106",2,"STRONG WIND","MA",0,126000,0,1,126000,1
"1107",2,"STRONG WIND","MD",0,205100,0,0,205100,0
"1108",2,"STRONG WIND","MI",0,16000,0,0,16000,0
"1109",2,"STRONG WIND","MO",0,23000,0,0,23000,0
"1110",2,"STRONG WIND","MS",0,150500,0,0,150500,0
"1111",2,"STRONG WIND","MT",25000,40000,0,0,65000,0
"1112",2,"STRONG WIND","NC",0,1022000,0,0,1022000,0
"1113",2,"STRONG WIND","NJ",0,1038750,0,0,1038750,0
"1114",2,"STRONG WIND","NM",0,4000,0,0,4000,0
"1115",2,"STRONG WIND","NV",0,20600,0,0,20600,0
"1116",2,"STRONG WIND","NY",0,13000,0,0,13000,0
"1117",2,"STRONG WIND","OH",0,150000,0,0,150000,0
"1118",2,"STRONG WIND","OR",0,285000,0,0,285000,0
"1119",2,"STRONG WIND","PA",0,531500,1,1,531500,2
"1120",2,"STRONG WIND","RI",0,13000,0,0,13000,0
"1121",2,"STRONG WIND","SC",0,62500,0,2,62500,2
"1122",2,"STRONG WIND","SD",0,0,0,1,0,1
"1123",2,"STRONG WIND","TN",0,135000,1,0,135000,1
"1124",2,"STRONG WIND","TX",0,416000,0,0,416000,0
"1125",2,"STRONG WIND","UT",0,3000,0,0,3000,0
"1126",2,"STRONG WIND","VA",0,54800,2,3,54800,5
"1127",2,"STRONG WIND","VT",0,39000,0,0,39000,0
"1128",2,"STRONG WIND","WA",0,1777000,1,1,1777000,2
"1129",2,"STRONG WIND","WI",0,4500,0,0,4500,0
"1130",2,"STRONG WIND","WV",0,42800,0,0,42800,0
"1131",2,"THUNDERSTORM WIND","AL",12500,9820450,1,138,9832950,139
"1132",2,"THUNDERSTORM WIND","AR",0,7069900,1,21,7069900,22
"1133",2,"THUNDERSTORM WIND","AZ",0,5500,0,0,5500,0
"1134",2,"THUNDERSTORM WIND","CA",0,577000,0,1,577000,1
"1135",2,"THUNDERSTORM WIND","CO",0,20000,0,0,20000,0
"1136",2,"THUNDERSTORM WIND","DC",0,5000,0,0,5000,0
"1137",2,"THUNDERSTORM WIND","DE",0,2e+05,0,2,2e+05,2
"1138",2,"THUNDERSTORM WIND","FL",7000,17785335,1,28,17792335,29
"1139",2,"THUNDERSTORM WIND","GA",68000,69326865,3,51,69394865,54
"1140",2,"THUNDERSTORM WIND","GU",0,125000,0,0,125000,0
"1141",2,"THUNDERSTORM WIND","HI",750000,0,0,0,750000,0
"1142",2,"THUNDERSTORM WIND","IA",0,353900,0,3,353900,3
"1143",2,"THUNDERSTORM WIND","ID",0,3035000,0,2,3035000,2
"1144",2,"THUNDERSTORM WIND","IL",0,2084500,0,12,2084500,12
"1145",2,"THUNDERSTORM WIND","IN",0,2134500,0,1,2134500,1
"1146",2,"THUNDERSTORM WIND","KS",0,303700,0,0,303700,0
"1147",2,"THUNDERSTORM WIND","KY",30000,12638500,2,9,12668500,11
"1148",2,"THUNDERSTORM WIND","LA",5000,28741650,2,55,28746650,57
"1149",2,"THUNDERSTORM WIND","MD",0,162000,0,0,162000,0
"1150",2,"THUNDERSTORM WIND","MI",0,107000,0,0,107000,0
"1151",2,"THUNDERSTORM WIND","MO",5000,1926800,0,0,1931800,0
"1152",2,"THUNDERSTORM WIND","MS",718000,67354550,0,10,68072550,10
"1153",2,"THUNDERSTORM WIND","NC",29000,205000,1,14,234000,15
"1154",2,"THUNDERSTORM WIND","NE",0,51000,0,0,51000,0
"1155",2,"THUNDERSTORM WIND","NJ",0,75000,0,0,75000,0
"1156",2,"THUNDERSTORM WIND","NY",0,101000,0,1,101000,1
"1157",2,"THUNDERSTORM WIND","OH",0,2314000,0,5,2314000,5
"1158",2,"THUNDERSTORM WIND","OK",0,12398910,1,10,12398910,11
"1159",2,"THUNDERSTORM WIND","PA",0,904500,0,2,904500,2
"1160",2,"THUNDERSTORM WIND","SC",0,466300,0,8,466300,8
"1161",2,"THUNDERSTORM WIND","TN",633000,9298700,1,13,9931700,14
"1162",2,"THUNDERSTORM WIND","TX",47759000,79552000,2,32,127311000,34
"1163",2,"THUNDERSTORM WIND","UT",0,38000,0,0,38000,0
"1164",2,"THUNDERSTORM WIND","VA",4000,254000,0,0,258000,0
"1165",2,"THUNDERSTORM WIND","VT",0,15000,0,0,15000,0
"1166",2,"THUNDERSTORM WIND","WI",0,66000,0,4,66000,4
"1167",2,"THUNDERSTORM WIND","WV",0,2016000,1,0,2016000,1
"1168",2,"TORNADO","AL",7500,85084780,20,524,85092280,544
"1169",2,"TORNADO","AR",0,190450750,22,392,190450750,414
"1170",2,"TORNADO","AZ",0,282500,0,0,282500,0
"1171",2,"TORNADO","CA",25000,12934750,0,11,12959750,11
"1172",2,"TORNADO","CO",0,2500,0,0,2500,0
"1173",2,"TORNADO","FL",2000,642597180,65,663,642599180,728
"1174",2,"TORNADO","GA",5152000,190432560,24,384,195584560,408
"1175",2,"TORNADO","HI",0,527500,0,1,527500,1
"1176",2,"TORNADO","IA",0,250000,0,1,250000,1
"1177",2,"TORNADO","ID",0,3460000,0,1,3460000,1
"1178",2,"TORNADO","IL",0,12777500,6,29,12777500,35
"1179",2,"TORNADO","IN",0,8231000,0,7,8231000,7
"1180",2,"TORNADO","KS",0,957500,0,1,957500,1
"1181",2,"TORNADO","KY",850000,44956000,9,57,45806000,66
"1182",2,"TORNADO","LA",450000,44199780,44,270,44649780,314
"1183",2,"TORNADO","MD",0,25000,0,0,25000,0
"1184",2,"TORNADO","MI",0,250,0,0,250,0
"1185",2,"TORNADO","MO",0,61768250,22,385,61768250,407
"1186",2,"TORNADO","MS",73000,238799500,152,2254,238872500,2406
"1187",2,"TORNADO","NC",0,12360750,3,71,12360750,74
"1188",2,"TORNADO","NJ",0,103000,0,0,103000,0
"1189",2,"TORNADO","NY",0,250000,0,2,250000,2
"1190",2,"TORNADO","OH",0,7900000,0,28,7900000,28
"1191",2,"TORNADO","OK",0,27033250,11,115,27033250,126
"1192",2,"TORNADO","OR",0,500,0,0,500,0
"1193",2,"TORNADO","PA",0,250000,0,0,250000,0
"1194",2,"TORNADO","SC",15000,8722280,0,18,8737280,18
"1195",2,"TORNADO","TN",1e+06,316743000,50,670,317743000,720
"1196",2,"TORNADO","TX",10000,59154840,8,142,59164840,150
"1197",2,"TORNADO","UT",0,25000,0,0,25000,0
"1198",2,"TORNADO","VA",30000,559500,0,1,589500,1
"1199",2,"TORNADO","WV",0,250000,0,0,250000,0
"1200",2,"TSUNAMI","CA",0,305000,0,0,305000,0
"1201",2,"WATERSPOUT","GM",0,25000,0,0,25000,0
"1202",2,"WATERSPOUT","NC",0,25000,0,0,25000,0
"1203",2,"WILDFIRE","AR",0,50000,0,0,50000,0
"1204",2,"WILDFIRE","CA",2e+06,17270000,0,28,19270000,28
"1205",2,"WILDFIRE","CO",0,0,0,2,0,2
"1206",2,"WILDFIRE","FL",0,850000,0,1,850000,1
"1207",2,"WILDFIRE","GA",0,32070,0,0,32070,0
"1208",2,"WILDFIRE","GU",0,25000,0,0,25000,0
"1209",2,"WILDFIRE","KS",30000,250000,0,3,280000,3
"1210",2,"WILDFIRE","MO",0,40000,0,0,40000,0
"1211",2,"WILDFIRE","NC",0,5000,0,0,5000,0
"1212",2,"WILDFIRE","NJ",0,10000,0,0,10000,0
"1213",2,"WILDFIRE","NM",0,207000,0,0,207000,0
"1214",2,"WILDFIRE","OK",0,15000,1,0,15000,1
"1215",2,"WILDFIRE","PR",0,2e+06,0,0,2e+06,0
"1216",2,"WILDFIRE","TX",27000,42020000,0,16,42047000,16
"1217",2,"WILDFIRE","VA",0,30000,0,0,30000,0
"1218",2,"WILDFIRE","WA",0,4e+06,0,2,4e+06,2
"1219",2,"WINTER STORM","AL",0,847000,0,0,847000,0
"1220",2,"WINTER STORM","AR",0,846000,0,0,846000,0
"1221",2,"WINTER STORM","CA",0,2150000,1,37,2150000,38
"1222",2,"WINTER STORM","CO",0,20000,0,5,20000,5
"1223",2,"WINTER STORM","CT",0,3880000,0,0,3880000,0
"1224",2,"WINTER STORM","DC",0,5000,0,0,5000,0
"1225",2,"WINTER STORM","DE",0,12700000,5,0,12700000,5
"1226",2,"WINTER STORM","GA",0,2e+05,0,0,2e+05,0
"1227",2,"WINTER STORM","IA",0,3903000,0,1,3903000,1
"1228",2,"WINTER STORM","ID",0,165000,2,7,165000,9
"1229",2,"WINTER STORM","IL",0,3510000,0,0,3510000,0
"1230",2,"WINTER STORM","KS",0,90000,3,17,90000,20
"1231",2,"WINTER STORM","KY",0,1010000,0,0,1010000,0
"1232",2,"WINTER STORM","MA",0,1339000,0,0,1339000,0
"1233",2,"WINTER STORM","MD",0,6670000,1,10,6670000,11
"1234",2,"WINTER STORM","MN",0,20000,0,0,20000,0
"1235",2,"WINTER STORM","MO",0,2004000,0,0,2004000,0
"1236",2,"WINTER STORM","MS",0,522000,0,0,522000,0
"1237",2,"WINTER STORM","MT",0,5050000,0,0,5050000,0
"1238",2,"WINTER STORM","NC",0,22617000,9,165,22617000,174
"1239",2,"WINTER STORM","NE",0,492000,1,8,492000,9
"1240",2,"WINTER STORM","NH",0,10000,0,0,10000,0
"1241",2,"WINTER STORM","NJ",0,12225000,1,2,12225000,3
"1242",2,"WINTER STORM","NV",0,250000,0,0,250000,0
"1243",2,"WINTER STORM","NY",0,1246000,1,0,1246000,1
"1244",2,"WINTER STORM","OH",0,13145000,0,0,13145000,0
"1245",2,"WINTER STORM","OK",0,20000,0,0,20000,0
"1246",2,"WINTER STORM","PA",0,19995000,4,1,19995000,5
"1247",2,"WINTER STORM","RI",0,70000,0,0,70000,0
"1248",2,"WINTER STORM","SD",0,17500,0,0,17500,0
"1249",2,"WINTER STORM","TN",0,40000,0,1,40000,1
"1250",2,"WINTER STORM","TX",50000,16883000,0,5,16933000,5
"1251",2,"WINTER STORM","UT",2e+05,920000,0,42,1120000,42
"1252",2,"WINTER STORM","VA",0,9218000,1,0,9218000,1
"1253",2,"WINTER STORM","VT",0,2086000,1,0,2086000,1
"1254",2,"WINTER STORM","WA",0,0,1,1,0,2
"1255",2,"WINTER STORM","WI",0,11000,0,0,11000,0
"1256",2,"WINTER STORM","WV",0,15039000,0,5,15039000,5
"1257",2,"WINTER STORM","WY",0,230000,0,28,230000,28
"1258",2,"WINTER WEATHER","AK",0,80000,1,1,80000,2
"1259",2,"WINTER WEATHER","AL",0,10000,0,0,10000,0
"1260",2,"WINTER WEATHER","AR",0,0,1,0,0,1
"1261",2,"WINTER WEATHER","CT",0,123000,1,0,123000,1
"1262",2,"WINTER WEATHER","DC",0,0,2,0,0,2
"1263",2,"WINTER WEATHER","IA",0,277000,0,0,277000,0
"1264",2,"WINTER WEATHER","IL",0,14000,0,0,14000,0
"1265",2,"WINTER WEATHER","IN",0,0,1,4,0,5
"1266",2,"WINTER WEATHER","KS",0,117000,0,0,117000,0
"1267",2,"WINTER WEATHER","LA",0,20000,0,0,20000,0
"1268",2,"WINTER WEATHER","MA",0,1e+05,0,0,1e+05,0
"1269",2,"WINTER WEATHER","MN",0,34000,1,6,34000,7
"1270",2,"WINTER WEATHER","MO",0,5000,0,0,5000,0
"1271",2,"WINTER WEATHER","MT",0,0,3,1,0,4
"1272",2,"WINTER WEATHER","NC",0,1000,0,0,1000,0
"1273",2,"WINTER WEATHER","NE",0,250000,0,0,250000,0
"1274",2,"WINTER WEATHER","NY",0,754000,0,0,754000,0
"1275",2,"WINTER WEATHER","OH",0,250000,0,0,250000,0
"1276",2,"WINTER WEATHER","OK",0,210000,0,0,210000,0
"1277",2,"WINTER WEATHER","PA",0,1e+05,0,0,1e+05,0
"1278",2,"WINTER WEATHER","SC",0,0,4,0,0,4
"1279",2,"WINTER WEATHER","TX",0,230200,2,5,230200,7
"1280",2,"WINTER WEATHER","VA",0,0,2,1,0,3
"1281",2,"WINTER WEATHER","VT",0,489000,1,0,489000,1
"1282",2,"WINTER WEATHER","WA",0,1e+05,0,3,1e+05,3
"1283",2,"WINTER WEATHER","WI",0,8000,0,2,8000,2
"1284",3,"AVALANCHE","AK",0,57000,8,2,57000,10
"1285",3,"AVALANCHE","CA",0,85000,1,0,85000,1
"1286",3,"AVALANCHE","CO",0,83500,18,9,83500,27
"1287",3,"AVALANCHE","ID",0,0,5,0,0,5
"1288",3,"AVALANCHE","NH",0,0,2,0,0,2
"1289",3,"AVALANCHE","OR",0,0,1,2,0,3
"1290",3,"AVALANCHE","UT",0,70000,6,13,70000,19
"1291",3,"AVALANCHE","WA",0,0,4,1,0,5
"1292",3,"AVALANCHE","WY",0,0,1,3,0,4
"1293",3,"BLIZZARD","CO",0,6.2e+07,0,2,6.2e+07,2
"1294",3,"BLIZZARD","DC",0,50000,0,2,50000,2
"1295",3,"BLIZZARD","GA",1.05e+08,55500000,14,402,160500000,416
"1296",3,"BLIZZARD","IA",0,305000,1,3,305000,4
"1297",3,"BLIZZARD","KS",0,720000,1,9,720000,10
"1298",3,"BLIZZARD","KY",0,0,1,0,0,1
"1299",3,"BLIZZARD","MD",0,550000,0,0,550000,0
"1300",3,"BLIZZARD","MN",0,190000,2,6,190000,8
"1301",3,"BLIZZARD","MT",0,1500000,0,0,1500000,0
"1302",3,"BLIZZARD","ND",0,15000,0,0,15000,0
"1303",3,"BLIZZARD","NE",0,20000,0,0,20000,0
"1304",3,"BLIZZARD","NY",0,62500000,7,4,62500000,11
"1305",3,"BLIZZARD","OH",0,5e+06,0,8,5e+06,8
"1306",3,"BLIZZARD","OK",0,1980000,0,0,1980000,0
"1307",3,"BLIZZARD","PA",0,5e+06,4,0,5e+06,4
"1308",3,"BLIZZARD","SD",0,16425000,1,10,16425000,11
"1309",3,"BLIZZARD","VA",0,5e+06,0,0,5e+06,0
"1310",3,"BLIZZARD","VT",0,5e+05,0,0,5e+05,0
"1311",3,"BLIZZARD","WV",0,555000,3,0,555000,3
"1312",3,"BLIZZARD","WY",0,9e+05,0,0,9e+05,0
"1313",3,"COASTAL FLOOD","AL",0,20000,0,0,20000,0
"1314",3,"COASTAL FLOOD","CT",0,0,1,0,0,1
"1315",3,"COASTAL FLOOD","DE",0,50000,0,0,50000,0
"1316",3,"COASTAL FLOOD","FL",0,181000,0,0,181000,0
"1317",3,"COASTAL FLOOD","MA",0,15025000,0,0,15025000,0
"1318",3,"COASTAL FLOOD","MD",0,5000,0,0,5000,0
"1319",3,"COASTAL FLOOD","ME",0,8000,0,0,8000,0
"1320",3,"COASTAL FLOOD","NH",0,9000,0,0,9000,0
"1321",3,"COASTAL FLOOD","NJ",0,3e+06,0,0,3e+06,0
"1322",3,"COASTAL FLOOD","NY",0,0,1,0,0,1
"1323",3,"COASTAL FLOOD","PR",0,220000,1,0,220000,1
"1324",3,"COASTAL FLOOD","VA",0,50000,0,0,50000,0
"1325",3,"COLD/WIND CHILL","AL",5.2e+07,0,1,0,5.2e+07,1
"1326",3,"COLD/WIND CHILL","AR",0,0,1,0,0,1
"1327",3,"COLD/WIND CHILL","CA",0,0,1,0,0,1
"1328",3,"COLD/WIND CHILL","DC",0,0,1,0,0,1
"1329",3,"COLD/WIND CHILL","IL",0,0,3,0,0,3
"1330",3,"COLD/WIND CHILL","LA",0,7200000,0,0,7200000,0
"1331",3,"COLD/WIND CHILL","MD",17500,0,1,0,17500,1
"1332",3,"COLD/WIND CHILL","MI",0,0,2,0,0,2
"1333",3,"COLD/WIND CHILL","NC",554000,0,10,1,554000,11
"1334",3,"COLD/WIND CHILL","SC",2e+07,0,2,0,2e+07,2
"1335",3,"COLD/WIND CHILL","SD",0,0,1,0,0,1
"1336",3,"COLD/WIND CHILL","TX",0,0,2,0,0,2
"1337",3,"COLD/WIND CHILL","VA",250000,0,1,0,250000,1
"1338",3,"COLD/WIND CHILL","WI",0,0,1,0,0,1
"1339",3,"COLD/WIND CHILL","WV",20000,0,0,0,20000,0
"1340",3,"DEBRIS FLOW","AL",0,1e+05,0,0,1e+05,0
"1341",3,"DEBRIS FLOW","CA",0,8054000,0,0,8054000,0
"1342",3,"DEBRIS FLOW","CO",0,1e+06,0,0,1e+06,0
"1343",3,"DEBRIS FLOW","PR",0,27000,0,0,27000,0
"1344",3,"DEBRIS FLOW","VA",0,150000,0,0,150000,0
"1345",3,"DEBRIS FLOW","WA",0,610000,0,0,610000,0
"1346",3,"DEBRIS FLOW","WV",0,1e+05,0,0,1e+05,0
"1347",3,"DENSE FOG","AL",0,9e+05,1,71,9e+05,72
"1348",3,"DENSE FOG","AZ",0,0,0,8,0,8
"1349",3,"DENSE FOG","CA",0,50000,0,4,50000,4
"1350",3,"DENSE FOG","FL",0,130000,0,3,130000,3
"1351",3,"DENSE FOG","IA",0,350000,0,0,350000,0
"1352",3,"DENSE FOG","LA",0,1e+05,0,0,1e+05,0
"1353",3,"DENSE FOG","MN",0,5000,0,0,5000,0
"1354",3,"DENSE FOG","NC",0,40000,0,0,40000,0
"1355",3,"DENSE FOG","NE",0,4e+05,0,1,4e+05,1
"1356",3,"DENSE FOG","NY",0,0,1,1,0,2
"1357",3,"DENSE FOG","TX",0,30000,0,0,30000,0
"1358",3,"DENSE FOG","WI",0,0,0,2,0,2
"1359",3,"DROUGHT","OK",7e+05,5e+06,0,0,5700000,0
"1360",3,"DROUGHT","PR",0,5e+06,0,0,5e+06,0
"1361",3,"DROUGHT","TX",220047000,4e+06,0,0,224047000,0
"1362",3,"DROUGHT","WA",0,1.2e+07,0,0,1.2e+07,0
"1363",3,"DUST DEVIL","FL",0,17000,0,0,17000,0
"1364",3,"DUST DEVIL","NC",0,300,0,0,300,0
"1365",3,"DUST DEVIL","SC",0,8000,0,0,8000,0
"1366",3,"DUST DEVIL","VA",0,8000,0,0,8000,0
"1367",3,"DUST DEVIL","WI",0,500,0,0,500,0
"1368",3,"DUST STORM","AZ",0,230000,0,5,230000,5
"1369",3,"DUST STORM","CA",0,115000,0,6,115000,6
"1370",3,"DUST STORM","MT",5e+05,50000,0,0,550000,0
"1371",3,"DUST STORM","WA",0,30000,0,4,30000,4
"1372",3,"EXTREME COLD/WIND CHILL","AK",0,0,1,0,0,1
"1373",3,"EXTREME COLD/WIND CHILL","IL",0,0,4,0,0,4
"1374",3,"EXTREME COLD/WIND CHILL","MI",0,0,2,0,0,2
"1375",3,"EXTREME COLD/WIND CHILL","MN",0,5e+05,0,0,5e+05,0
"1376",3,"EXTREME COLD/WIND CHILL","ND",0,360000,0,2,360000,2
"1377",3,"EXTREME COLD/WIND CHILL","NY",0,0,1,0,0,1
"1378",3,"FLASH FLOOD","AL",1e+05,110339000,5,1,110439000,6
"1379",3,"FLASH FLOOD","AR",0,33951000,2,0,33951000,2
"1380",3,"FLASH FLOOD","AZ",0,115000,3,0,115000,3
"1381",3,"FLASH FLOOD","CA",1e+06,44806000.41,8,1,45806000.41,9
"1382",3,"FLASH FLOOD","DC",0,5000,0,0,5000,0
"1383",3,"FLASH FLOOD","FL",0,654000,1,0,654000,1
"1384",3,"FLASH FLOOD","GA",0,3706850,1,0,3706850,1
"1385",3,"FLASH FLOOD","HI",150000,7e+05,7,0,850000,7
"1386",3,"FLASH FLOOD","IA",0,2e+06,0,0,2e+06,0
"1387",3,"FLASH FLOOD","ID",0,5000,0,0,5000,0
"1388",3,"FLASH FLOOD","IL",0,825000,0,2,825000,2
"1389",3,"FLASH FLOOD","IN",10000,1663000,1,0,1673000,1
"1390",3,"FLASH FLOOD","KS",90000,148000,0,0,238000,0
"1391",3,"FLASH FLOOD","KY",500,72579000,8,1,72579500,9
"1392",3,"FLASH FLOOD","LA",0,4952200,0,0,4952200,0
"1393",3,"FLASH FLOOD","MA",0,5e+05,0,0,5e+05,0
"1394",3,"FLASH FLOOD","MD",0,2000,0,0,2000,0
"1395",3,"FLASH FLOOD","ME",0,55000,0,0,55000,0
"1396",3,"FLASH FLOOD","MI",0,250000,0,0,250000,0
"1397",3,"FLASH FLOOD","MN",0,5651000,0,0,5651000,0
"1398",3,"FLASH FLOOD","MO",51300,44338000,4,2,44389300,6
"1399",3,"FLASH FLOOD","MS",0,20234000,1,0,20234000,1
"1400",3,"FLASH FLOOD","MT",0,615000,0,0,615000,0
"1401",3,"FLASH FLOOD","NC",0,2165000,0,0,2165000,0
"1402",3,"FLASH FLOOD","ND",0,47000,0,0,47000,0
"1403",3,"FLASH FLOOD","NE",0,54000,0,1,54000,1
"1404",3,"FLASH FLOOD","NJ",0,1e+05,0,0,1e+05,0
"1405",3,"FLASH FLOOD","NV",0,2500000,0,1,2500000,1
"1406",3,"FLASH FLOOD","NY",0,460500,0,0,460500,0
"1407",3,"FLASH FLOOD","OH",0,30213000,4,0,30213000,4
"1408",3,"FLASH FLOOD","OK",0,6689000,1,2,6689000,3
"1409",3,"FLASH FLOOD","PA",0,1047500,0,1,1047500,1
"1410",3,"FLASH FLOOD","PR",0,2657000,0,0,2657000,0
"1411",3,"FLASH FLOOD","SC",0,568000,1,0,568000,1
"1412",3,"FLASH FLOOD","SD",0,295000,0,0,295000,0
"1413",3,"FLASH FLOOD","TN",0,158949004,6,0,158949004,6
"1414",3,"FLASH FLOOD","TX",5e+05,35044000,15,9,35544000,24
"1415",3,"FLASH FLOOD","UT",0,5000,0,4,5000,4
"1416",3,"FLASH FLOOD","VA",0,4796000,1,0,4796000,1
"1417",3,"FLASH FLOOD","VT",0,260500,0,0,260500,0
"1418",3,"FLASH FLOOD","WI",0,60000,0,0,60000,0
"1419",3,"FLASH FLOOD","WV",0,18711000,0,2,18711000,2
"1420",3,"FLOOD","AL",5e+05,242755000,0,0,243255000,0
"1421",3,"FLOOD","AR",2815000,105998000,1,0,108813000,1
"1422",3,"FLOOD","AZ",0,2900000,0,0,2900000,0
"1423",3,"FLOOD","CA",444450000,19280000,4,6,463730000,10
"1424",3,"FLOOD","CO",0,62000,0,0,62000,0
"1425",3,"FLOOD","CT",0,11168000,0,3,11168000,3
"1426",3,"FLOOD","FL",1e+05,440839500,2,0,440939500,2
"1427",3,"FLOOD","GA",0,166581000,1,1,166581000,2
"1428",3,"FLOOD","IA",0,56843500,0,1,56843500,1
"1429",3,"FLOOD","ID",0,1810000,0,0,1810000,0
"1430",3,"FLOOD","IL",0,38912000,2,0,38912000,2
"1431",3,"FLOOD","IN",0,80034000,3,0,80034000,3
"1432",3,"FLOOD","KS",25000,390000,1,0,415000,1
"1433",3,"FLOOD","KY",5000,393428000,12,5,393433000,17
"1434",3,"FLOOD","LA",0,2692000,1,0,2692000,1
"1435",3,"FLOOD","MA",0,162382000,0,5,162382000,5
"1436",3,"FLOOD","MD",0,77000,0,0,77000,0
"1437",3,"FLOOD","ME",0,2643000,1,0,2643000,1
"1438",3,"FLOOD","MI",0,4412050,0,0,4412050,0
"1439",3,"FLOOD","MN",0,7975000,1,0,7975000,1
"1440",3,"FLOOD","MO",0,27126000,3,0,27126000,3
"1441",3,"FLOOD","MS",0,7391000,0,0,7391000,0
"1442",3,"FLOOD","MT",5e+06,12775000,0,0,17775000,0
"1443",3,"FLOOD","NC",0,8850000,1,0,8850000,1
"1444",3,"FLOOD","ND",5e+06,20489000,2,1,25489000,3
"1445",3,"FLOOD","NE",0,1813000,2,0,1813000,2
"1446",3,"FLOOD","NH",0,2683000,0,0,2683000,0
"1447",3,"FLOOD","NJ",0,89910000,0,0,89910000,0
"1448",3,"FLOOD","NV",0,1500000,0,0,1500000,0
"1449",3,"FLOOD","NY",0,24247500,2,0,24247500,2
"1450",3,"FLOOD","OH",0,24218500,2,0,24218500,2
"1451",3,"FLOOD","OK",250000,1185000,1,3,1435000,4
"1452",3,"FLOOD","OR",0,6100000,2,1,6100000,3
"1453",3,"FLOOD","PA",0,3030000,1,3,3030000,4
"1454",3,"FLOOD","PR",0,12000,0,0,12000,0
"1455",3,"FLOOD","RI",0,90950000,0,0,90950000,0
"1456",3,"FLOOD","SC",0,2427000,1,0,2427000,1
"1457",3,"FLOOD","SD",250000,7005000,2,0,7255000,2
"1458",3,"FLOOD","TN",155000,26031000,3,0,26186000,3
"1459",3,"FLOOD","TX",1e+05,1507000,2,1,1607000,3
"1460",3,"FLOOD","UT",0,116000.8,0,0,116000.8,0
"1461",3,"FLOOD","VA",5000,1679900,0,0,1684900,0
"1462",3,"FLOOD","VT",0,543000,0,3,543000,3
"1463",3,"FLOOD","WA",0,1411000,0,0,1411000,0
"1464",3,"FLOOD","WI",0,1449000,0,0,1449000,0
"1465",3,"FLOOD","WV",0,10956000,5,1,10956000,6
"1466",3,"FROST/FREEZE","CA",20000,0,0,0,20000,0
"1467",3,"FROST/FREEZE","IA",0,5000,0,0,5000,0
"1468",3,"FROST/FREEZE","LA",5e+07,0,1,0,5e+07,1
"1469",3,"FROST/FREEZE","WA",0,50000,0,11,50000,11
"1470",3,"FUNNEL CLOUD","SC",0,50000,0,0,50000,0
"1471",3,"HAIL","AL",211000,5021500,0,0,5232500,0
"1472",3,"HAIL","AR",5000,92317610,0,1,92322610,1
"1473",3,"HAIL","AZ",0,2000,0,0,2000,0
"1474",3,"HAIL","CA",62245000,659000,1,9,62904000,10
"1475",3,"HAIL","FL",2521250,1629721500,26,4,1632242750,30
"1476",3,"HAIL","GA",5000,68277700,0,1,68282700,1
"1477",3,"HAIL","IA",0,1129500,0,0,1129500,0
"1478",3,"HAIL","IL",0,193000,0,1,193000,1
"1479",3,"HAIL","IN",0,10000,0,0,10000,0
"1480",3,"HAIL","KS",39000,76056000,0,0,76095000,0
"1481",3,"HAIL","KY",10000,233000,0,0,243000,0
"1482",3,"HAIL","LA",0,3486300,0,5,3486300,5
"1483",3,"HAIL","MD",0,2000,0,0,2000,0
"1484",3,"HAIL","MI",35000,165000,0,0,2e+05,0
"1485",3,"HAIL","MN",0,557000,0,0,557000,0
"1486",3,"HAIL","MO",1800,8890720,0,0,8892520,0
"1487",3,"HAIL","MS",20000,48333340,0,2,48353340,2
"1488",3,"HAIL","NC",0,6109250,0,0,6109250,0
"1489",3,"HAIL","NE",0,477500,0,0,477500,0
"1490",3,"HAIL","NJ",0,110000,0,0,110000,0
"1491",3,"HAIL","NM",0,7200000,0,0,7200000,0
"1492",3,"HAIL","NY",0,15000,0,0,15000,0
"1493",3,"HAIL","OH",0,116000,0,0,116000,0
"1494",3,"HAIL","OK",0,8467000,0,0,8467000,0
"1495",3,"HAIL","SC",6000,3362000,0,0,3368000,0
"1496",3,"HAIL","TN",39000,161310,0,0,200310,0
"1497",3,"HAIL","TX",617000,806048553,1,5,806665553,6
"1498",3,"HAIL","UT",0,1000,1,1,1000,2
"1499",3,"HAIL","VA",0,7000,0,0,7000,0
"1500",3,"HAIL","VT",0,5000,0,0,5000,0
"1501",3,"HAIL","WI",0,146000,0,2,146000,2
"1502",3,"HAIL","WV",0,91000,0,0,91000,0
"1503",3,"HEAT","MD",10000,0,0,0,10000,0
"1504",3,"HEAVY RAIN","AL",0,113000,1,0,113000,1
"1505",3,"HEAVY RAIN","AZ",0,5e+05,0,0,5e+05,0
"1506",3,"HEAVY RAIN","CA",0,10188502,1,0,10188502,1
"1507",3,"HEAVY RAIN","CO",0,20000,0,1,20000,1
"1508",3,"HEAVY RAIN","FL",0,4000,0,0,4000,0
"1509",3,"HEAVY RAIN","GA",0,312000,0,0,312000,0
"1510",3,"HEAVY RAIN","IA",0,10000,0,0,10000,0
"1511",3,"HEAVY RAIN","MA",0,50000,0,0,50000,0
"1512",3,"HEAVY RAIN","MD",0,5e+06,0,0,5e+06,0
"1513",3,"HEAVY RAIN","MS",0,25000,0,0,25000,0
"1514",3,"HEAVY RAIN","NY",0,90000,0,0,90000,0
"1515",3,"HEAVY RAIN","OH",0,405000,1,0,405000,1
"1516",3,"HEAVY RAIN","OK",0,5e+05,0,0,5e+05,0
"1517",3,"HEAVY RAIN","PR",0,54000,0,0,54000,0
"1518",3,"HEAVY RAIN","TN",0,50000,0,0,50000,0
"1519",3,"HEAVY RAIN","TX",0,53000,0,0,53000,0
"1520",3,"HEAVY RAIN","VA",0,3000,0,0,3000,0
"1521",3,"HEAVY RAIN","VT",0,565000,0,0,565000,0
"1522",3,"HEAVY RAIN","WA",0,29650000,0,3,29650000,3
"1523",3,"HEAVY SNOW","AK",0,82750,0,0,82750,0
"1524",3,"HEAVY SNOW","AR",0,220000,0,0,220000,0
"1525",3,"HEAVY SNOW","AZ",0,5000,0,15,5000,15
"1526",3,"HEAVY SNOW","CA",0,50000,0,32,50000,32
"1527",3,"HEAVY SNOW","CO",0,5000,0,0,5000,0
"1528",3,"HEAVY SNOW","CT",0,7e+06,0,0,7e+06,0
"1529",3,"HEAVY SNOW","GA",5e+05,5083000,0,0,5583000,0
"1530",3,"HEAVY SNOW","IA",0,3208000,1,0,3208000,1
"1531",3,"HEAVY SNOW","ID",0,85000,1,1,85000,2
"1532",3,"HEAVY SNOW","IL",0,5e+05,1,14,5e+05,15
"1533",3,"HEAVY SNOW","KS",0,308000,0,0,308000,0
"1534",3,"HEAVY SNOW","KY",0,10000,0,0,10000,0
"1535",3,"HEAVY SNOW","MA",0,16250000,2,0,16250000,2
"1536",3,"HEAVY SNOW","ME",0,0,1,0,0,1
"1537",3,"HEAVY SNOW","MI",0,550000,0,0,550000,0
"1538",3,"HEAVY SNOW","MO",0,5e+06,0,0,5e+06,0
"1539",3,"HEAVY SNOW","MS",0,220000,0,0,220000,0
"1540",3,"HEAVY SNOW","MT",0,60000,0,1,60000,1
"1541",3,"HEAVY SNOW","NC",0,2800,0,0,2800,0
"1542",3,"HEAVY SNOW","ND",0,15000,1,1,15000,2
"1543",3,"HEAVY SNOW","NH",0,5703000,0,14,5703000,14
"1544",3,"HEAVY SNOW","NM",0,40000,0,0,40000,0
"1545",3,"HEAVY SNOW","NV",20000,1505000,5,7,1525000,12
"1546",3,"HEAVY SNOW","NY",0,20326000,6,13,20326000,19
"1547",3,"HEAVY SNOW","OH",0,11736000,0,0,11736000,0
"1548",3,"HEAVY SNOW","OK",0,621500,0,0,621500,0
"1549",3,"HEAVY SNOW","OR",0,10000,0,5,10000,5
"1550",3,"HEAVY SNOW","PA",0,58590000,0,13,58590000,13
"1551",3,"HEAVY SNOW","RI",0,10600000,0,0,10600000,0
"1552",3,"HEAVY SNOW","SC",5e+06,5e+06,0,0,1e+07,0
"1553",3,"HEAVY SNOW","SD",10000,210000,0,3,220000,3
"1554",3,"HEAVY SNOW","TN",0,65000,0,1,65000,1
"1555",3,"HEAVY SNOW","TX",0,5e+05,1,0,5e+05,1
"1556",3,"HEAVY SNOW","UT",6000,6e+05,0,37,606000,37
"1557",3,"HEAVY SNOW","VA",0,4000,0,0,4000,0
"1558",3,"HEAVY SNOW","VT",0,1905000,1,0,1905000,1
"1559",3,"HEAVY SNOW","WV",0,14000,0,0,14000,0
"1560",3,"HIGH SURF","AK",0,5e+05,4,0,5e+05,4
"1561",3,"HIGH SURF","CA",0,310000,5,6,310000,11
"1562",3,"HIGH SURF","FL",0,0,1,0,0,1
"1563",3,"HIGH SURF","HI",0,0,1,1,0,2
"1564",3,"HIGH SURF","ME",0,1e+05,0,0,1e+05,0
"1565",3,"HIGH SURF","NJ",0,0,1,0,0,1
"1566",3,"HIGH SURF","NY",0,3.1e+07,0,0,3.1e+07,0
"1567",3,"HIGH SURF","PR",0,2642000,2,6,2642000,8
"1568",3,"HIGH SURF","VI",0,0,2,0,0,2
"1569",3,"HIGH WIND","AK",0,12453500,0,2,12453500,2
"1570",3,"HIGH WIND","AL",0,19000,1,1,19000,2
"1571",3,"HIGH WIND","AR",0,75100,0,0,75100,0
"1572",3,"HIGH WIND","AZ",0,265000,2,17,265000,19
"1573",3,"HIGH WIND","CA",22540000,7274000,0,17,29814000,17
"1574",3,"HIGH WIND","CO",0,119150,0,4,119150,4
"1575",3,"HIGH WIND","CT",0,1765000,2,4,1765000,6
"1576",3,"HIGH WIND","DC",0,50000,0,0,50000,0
"1577",3,"HIGH WIND","DE",0,140000,0,0,140000,0
"1578",3,"HIGH WIND","FL",0,11320000,7,4,11320000,11
"1579",3,"HIGH WIND","GA",5e+05,51550000,2,20,52050000,22
"1580",3,"HIGH WIND","HI",550000,1230000,0,1,1780000,1
"1581",3,"HIGH WIND","IA",0,5232000,0,0,5232000,0
"1582",3,"HIGH WIND","ID",0,434000,0,1,434000,1
"1583",3,"HIGH WIND","IL",0,508000,6,16,508000,22
"1584",3,"HIGH WIND","IN",0,166000,0,1,166000,1
"1585",3,"HIGH WIND","KS",0,819000,1,0,819000,1
"1586",3,"HIGH WIND","KY",0,180000,0,0,180000,0
"1587",3,"HIGH WIND","LA",0,962000,0,0,962000,0
"1588",3,"HIGH WIND","MA",0,1761980,0,0,1761980,0
"1589",3,"HIGH WIND","MD",0,5875000,0,6,5875000,6
"1590",3,"HIGH WIND","ME",0,0,0,1,0,1
"1591",3,"HIGH WIND","MI",0,1330000,1,4,1330000,5
"1592",3,"HIGH WIND","MN",0,105000,0,0,105000,0
"1593",3,"HIGH WIND","MO",0,399000,0,0,399000,0
"1594",3,"HIGH WIND","MS",0,95000,0,0,95000,0
"1595",3,"HIGH WIND","MT",0,28000,0,3,28000,3
"1596",3,"HIGH WIND","NC",19000,3388200,2,11,3407200,13
"1597",3,"HIGH WIND","ND",0,55000,0,0,55000,0
"1598",3,"HIGH WIND","NE",0,632000,0,6,632000,6
"1599",3,"HIGH WIND","NH",0,0,0,1,0,1
"1600",3,"HIGH WIND","NJ",0,16810000,2,4,16810000,6
"1601",3,"HIGH WIND","NM",0,361200,0,8,361200,8
"1602",3,"HIGH WIND","NV",0,1525000,1,11,1525000,12
"1603",3,"HIGH WIND","NY",0,10063000,7,15,10063000,22
"1604",3,"HIGH WIND","OH",0,13918000,4,24,13918000,28
"1605",3,"HIGH WIND","OK",0,243500,0,0,243500,0
"1606",3,"HIGH WIND","OR",0,534000,1,2,534000,3
"1607",3,"HIGH WIND","PA",0,6375000,2,2,6375000,4
"1608",3,"HIGH WIND","RI",0,250000,0,0,250000,0
"1609",3,"HIGH WIND","SC",12005000,116417750,1,4,128422750,5
"1610",3,"HIGH WIND","SD",0,2105000,0,0,2105000,0
"1611",3,"HIGH WIND","TN",46000,197000,0,0,243000,0
"1612",3,"HIGH WIND","TX",0,1537500,1,14,1537500,15
"1613",3,"HIGH WIND","UT",170000,2900000,0,1,3070000,1
"1614",3,"HIGH WIND","VA",0,1759080,1,6,1759080,7
"1615",3,"HIGH WIND","VT",0,835000,0,0,835000,0
"1616",3,"HIGH WIND","WA",0,5344500,8,8,5344500,16
"1617",3,"HIGH WIND","WI",0,453000,0,1,453000,1
"1618",3,"HIGH WIND","WV",0,384000,0,0,384000,0
"1619",3,"HIGH WIND","WY",0,644000,0,0,644000,0
"1620",3,"HURRICANE/TYPHOON","GU",1e+08,5e+07,1,0,1.5e+08,1
"1621",3,"ICE STORM","AK",0,0,5,0,0,5
"1622",3,"ICE STORM","IA",0,814880,0,0,814880,0
"1623",3,"ICE STORM","KS",0,3475000,3,5,3475000,8
"1624",3,"ICE STORM","KY",0,0,2,0,0,2
"1625",3,"ICE STORM","MD",0,151000,0,0,151000,0
"1626",3,"ICE STORM","MI",0,19010000,0,0,19010000,0
"1627",3,"ICE STORM","MN",0,855000,0,0,855000,0
"1628",3,"ICE STORM","ND",0,25000,0,0,25000,0
"1629",3,"ICE STORM","NE",0,56000,0,8,56000,8
"1630",3,"ICE STORM","NH",0,4e+05,0,0,4e+05,0
"1631",3,"ICE STORM","NY",0,55000,0,0,55000,0
"1632",3,"ICE STORM","OH",0,5500000,0,14,5500000,14
"1633",3,"ICE STORM","PA",0,50520000,0,0,50520000,0
"1634",3,"ICE STORM","SD",0,250000,2,1,250000,3
"1635",3,"ICE STORM","TN",0,76000,0,0,76000,0
"1636",3,"ICE STORM","VA",0,75000,0,0,75000,0
"1637",3,"ICE STORM","WA",0,0,2,1,0,3
"1638",3,"ICE STORM","WY",0,87000,1,5,87000,6
"1639",3,"LIGHTNING","AL",0,1415500,1,7,1415500,8
"1640",3,"LIGHTNING","AR",0,1664000,1,3,1664000,4
"1641",3,"LIGHTNING","AS",0,120000,0,0,120000,0
"1642",3,"LIGHTNING","AZ",0,6000,0,0,6000,0
"1643",3,"LIGHTNING","CA",10000,131000,0,5,141000,5
"1644",3,"LIGHTNING","CT",0,60000,0,0,60000,0
"1645",3,"LIGHTNING","FL",0,4003500,3,21,4003500,24
"1646",3,"LIGHTNING","GA",0,2838000,2,2,2838000,4
"1647",3,"LIGHTNING","IA",0,248500,0,1,248500,1
"1648",3,"LIGHTNING","IL",0,0,1,1,0,2
"1649",3,"LIGHTNING","IN",0,328000,0,0,328000,0
"1650",3,"LIGHTNING","KS",0,247000,0,0,247000,0
"1651",3,"LIGHTNING","KY",0,126000,0,1,126000,1
"1652",3,"LIGHTNING","LA",0,10742200,1,4,10742200,5
"1653",3,"LIGHTNING","MA",0,58000,0,0,58000,0
"1654",3,"LIGHTNING","MD",1000,0,0,1,1000,1
"1655",3,"LIGHTNING","ME",0,325000,0,0,325000,0
"1656",3,"LIGHTNING","MI",0,3e+05,0,0,3e+05,0
"1657",3,"LIGHTNING","MN",0,50000,0,1,50000,1
"1658",3,"LIGHTNING","MO",0,371500,0,0,371500,0
"1659",3,"LIGHTNING","MS",0,2565000,0,1,2565000,1
"1660",3,"LIGHTNING","NC",0,680500,0,0,680500,0
"1661",3,"LIGHTNING","NE",0,73000,0,0,73000,0
"1662",3,"LIGHTNING","NH",0,1e+05,0,1,1e+05,1
"1663",3,"LIGHTNING","NJ",0,1000,0,0,1000,0
"1664",3,"LIGHTNING","NM",0,500,0,1,500,1
"1665",3,"LIGHTNING","NY",0,222000,1,1,222000,2
"1666",3,"LIGHTNING","OH",0,0,1,2,0,3
"1667",3,"LIGHTNING","OK",0,592900,0,0,592900,0
"1668",3,"LIGHTNING","PA",0,152000,0,0,152000,0
"1669",3,"LIGHTNING","RI",0,50000,0,0,50000,0
"1670",3,"LIGHTNING","SC",0,775500,0,4,775500,4
"1671",3,"LIGHTNING","TN",0,1523000,0,6,1523000,6
"1672",3,"LIGHTNING","TX",0,1532500,2,3,1532500,5
"1673",3,"LIGHTNING","VA",0,190000,0,5,190000,5
"1674",3,"LIGHTNING","VT",0,253000,0,0,253000,0
"1675",3,"LIGHTNING","WI",0,436700,0,1,436700,1
"1676",3,"LIGHTNING","WV",0,46000,0,8,46000,8
"1677",3,"MARINE STRONG WIND","AN",0,0,0,5,0,5
"1678",3,"MARINE STRONG WIND","LM",0,10000,0,0,10000,0
"1679",3,"MARINE STRONG WIND","PZ",0,25000,2,0,25000,2
"1680",3,"MARINE THUNDERSTORM WIND","AM",0,0,2,4,0,6
"1681",3,"MARINE THUNDERSTORM WIND","AN",0,0,5,0,0,5
"1682",3,"RIP CURRENT","CA",0,0,7,0,0,7
"1683",3,"RIP CURRENT","FL",0,0,16,15,0,31
"1684",3,"RIP CURRENT","GU",0,0,2,1,0,3
"1685",3,"RIP CURRENT","OR",0,0,2,0,0,2
"1686",3,"RIP CURRENT","PR",0,0,3,0,0,3
"1687",3,"RIP CURRENT","VI",0,0,1,0,0,1
"1688",3,"SEICHE","NY",0,35000,0,0,35000,0
"1689",3,"STORM SURGE/TIDE","CA",0,1e+05,0,0,1e+05,0
"1690",3,"STORM SURGE/TIDE","FL",0,1.3e+08,11,1,1.3e+08,12
"1691",3,"STORM SURGE/TIDE","ME",0,378000,0,0,378000,0
"1692",3,"STORM SURGE/TIDE","NC",0,10000,0,0,10000,0
"1693",3,"STORM SURGE/TIDE","NH",0,215000,0,0,215000,0
"1694",3,"STORM SURGE/TIDE","OH",0,650000,0,0,650000,0
"1695",3,"STORM SURGE/TIDE","PA",0,1e+05,0,0,1e+05,0
"1696",3,"STORM SURGE/TIDE","WA",0,1e+06,0,0,1e+06,0
"1697",3,"STRONG WIND","AK",0,7000,0,0,7000,0
"1698",3,"STRONG WIND","AL",0,403000,0,3,403000,3
"1699",3,"STRONG WIND","AR",0,0,1,0,0,1
"1700",3,"STRONG WIND","AS",1000,0,0,0,1000,0
"1701",3,"STRONG WIND","AZ",0,97000,0,0,97000,0
"1702",3,"STRONG WIND","CA",1000,322200,1,2,323200,3
"1703",3,"STRONG WIND","CO",0,3000,0,0,3000,0
"1704",3,"STRONG WIND","CT",0,10000,0,0,10000,0
"1705",3,"STRONG WIND","DC",0,40000,1,3,40000,4
"1706",3,"STRONG WIND","DE",0,112000,0,0,112000,0
"1707",3,"STRONG WIND","FL",2000,59000,0,0,61000,0
"1708",3,"STRONG WIND","GA",3000,247500,1,3,250500,4
"1709",3,"STRONG WIND","HI",0,350000,0,9,350000,9
"1710",3,"STRONG WIND","ID",0,47000,0,0,47000,0
"1711",3,"STRONG WIND","IL",0,170000,0,5,170000,5
"1712",3,"STRONG WIND","IN",0,66000,0,0,66000,0
"1713",3,"STRONG WIND","KS",0,8000,0,0,8000,0
"1714",3,"STRONG WIND","KY",0,9000,0,0,9000,0
"1715",3,"STRONG WIND","LA",0,1088000,1,1,1088000,2
"1716",3,"STRONG WIND","MA",0,207000,0,1,207000,1
"1717",3,"STRONG WIND","MD",0,333500,0,1,333500,1
"1718",3,"STRONG WIND","ME",0,0,0,2,0,2
"1719",3,"STRONG WIND","MO",0,18000,0,0,18000,0
"1720",3,"STRONG WIND","MS",0,1094800,0,0,1094800,0
"1721",3,"STRONG WIND","MT",0,2000,0,0,2000,0
"1722",3,"STRONG WIND","NC",2000,73000,1,0,75000,1
"1723",3,"STRONG WIND","NE",0,10500,1,0,10500,1
"1724",3,"STRONG WIND","NH",0,10000,2,4,10000,6
"1725",3,"STRONG WIND","NJ",0,239900,0,3,239900,3
"1726",3,"STRONG WIND","NV",0,1155000,0,2,1155000,2
"1727",3,"STRONG WIND","NY",0,71500,1,2,71500,3
"1728",3,"STRONG WIND","OH",0,596000,1,0,596000,1
"1729",3,"STRONG WIND","OR",0,125200,0,0,125200,0
"1730",3,"STRONG WIND","PA",0,354500,0,0,354500,0
"1731",3,"STRONG WIND","RI",0,11000,0,0,11000,0
"1732",3,"STRONG WIND","SC",0,7000,5,0,7000,5
"1733",3,"STRONG WIND","TN",5000,33200,1,1,38200,2
"1734",3,"STRONG WIND","TX",0,137000,0,1,137000,1
"1735",3,"STRONG WIND","VA",0,101000,0,0,101000,0
"1736",3,"STRONG WIND","VT",0,30000,0,0,30000,0
"1737",3,"STRONG WIND","WA",0,547200,1,1,547200,2
"1738",3,"STRONG WIND","WI",0,190000,0,0,190000,0
"1739",3,"STRONG WIND","WV",0,106000,0,0,106000,0
"1740",3,"THUNDERSTORM WIND","AL",5188000,14881750,4,48,20069750,52
"1741",3,"THUNDERSTORM WIND","AR",0,9755300,0,17,9755300,17
"1742",3,"THUNDERSTORM WIND","AZ",0,61000,0,0,61000,0
"1743",3,"THUNDERSTORM WIND","CA",45000,281500,3,0,326500,3
"1744",3,"THUNDERSTORM WIND","CO",0,52000,0,0,52000,0
"1745",3,"THUNDERSTORM WIND","CT",0,2000,0,0,2000,0
"1746",3,"THUNDERSTORM WIND","DC",0,15000,0,0,15000,0
"1747",3,"THUNDERSTORM WIND","DE",0,5000,0,2,5000,2
"1748",3,"THUNDERSTORM WIND","FL",64150,44210470,3,49,44274620,52
"1749",3,"THUNDERSTORM WIND","GA",7300,9895709,1,22,9903009,23
"1750",3,"THUNDERSTORM WIND","HI",0,12000,0,0,12000,0
"1751",3,"THUNDERSTORM WIND","IA",0,4824200,0,6,4824200,6
"1752",3,"THUNDERSTORM WIND","ID",0,2015000,0,1,2015000,1
"1753",3,"THUNDERSTORM WIND","IL",0,6774000,2,22,6774000,24
"1754",3,"THUNDERSTORM WIND","IN",0,1498500,1,10,1498500,11
"1755",3,"THUNDERSTORM WIND","KS",0,11688200,0,6,11688200,6
"1756",3,"THUNDERSTORM WIND","KY",0,2543000,1,54,2543000,55
"1757",3,"THUNDERSTORM WIND","LA",0,14490550,2,25,14490550,27
"1758",3,"THUNDERSTORM WIND","MA",0,6000,0,0,6000,0
"1759",3,"THUNDERSTORM WIND","MD",0,560000,2,2,560000,4
"1760",3,"THUNDERSTORM WIND","MI",0,808500,3,22,808500,25
"1761",3,"THUNDERSTORM WIND","MN",0,10000,0,0,10000,0
"1762",3,"THUNDERSTORM WIND","MO",758400,2917500,0,7,3675900,7
"1763",3,"THUNDERSTORM WIND","MS",221000,49358122,2,27,49579122,29
"1764",3,"THUNDERSTORM WIND","MT",0,28000,0,1,28000,1
"1765",3,"THUNDERSTORM WIND","NC",0,7429000,2,30,7429000,32
"1766",3,"THUNDERSTORM WIND","NE",0,1195500,0,4,1195500,4
"1767",3,"THUNDERSTORM WIND","NJ",0,485000,2,2,485000,4
"1768",3,"THUNDERSTORM WIND","NM",0,10000,1,2,10000,3
"1769",3,"THUNDERSTORM WIND","NY",0,238000,0,4,238000,4
"1770",3,"THUNDERSTORM WIND","OH",0,1295500,1,6,1295500,7
"1771",3,"THUNDERSTORM WIND","OK",0,12450060,0,28,12450060,28
"1772",3,"THUNDERSTORM WIND","OR",0,21000,0,0,21000,0
"1773",3,"THUNDERSTORM WIND","PA",0,4158000,0,2,4158000,2
"1774",3,"THUNDERSTORM WIND","RI",0,6000,0,0,6000,0
"1775",3,"THUNDERSTORM WIND","SC",4000,2736700,4,28,2740700,32
"1776",3,"THUNDERSTORM WIND","SD",0,150000,0,0,150000,0
"1777",3,"THUNDERSTORM WIND","TN",165000,2113000,0,8,2278000,8
"1778",3,"THUNDERSTORM WIND","TX",1445500,49333900,4,81,50779400,85
"1779",3,"THUNDERSTORM WIND","UT",2200,5000,0,0,7200,0
"1780",3,"THUNDERSTORM WIND","VA",9000,2239153,0,4,2248153,4
"1781",3,"THUNDERSTORM WIND","VT",0,10000,0,0,10000,0
"1782",3,"THUNDERSTORM WIND","WA",0,11000,0,0,11000,0
"1783",3,"THUNDERSTORM WIND","WI",0,488250,0,0,488250,0
"1784",3,"THUNDERSTORM WIND","WV",0,552000,0,0,552000,0
"1785",3,"THUNDERSTORM WIND","WY",0,52500,0,0,52500,0
"1786",3,"TORNADO","AL",50414500,386451810,63,799,436866310,862
"1787",3,"TORNADO","AR",1120010,570095730,164,1512,571215740,1676
"1788",3,"TORNADO","AZ",0,107500,0,3,107500,3
"1789",3,"TORNADO","CA",50000,33297120,0,36,33347120,36
"1790",3,"TORNADO","CO",0,4026250,2,9,4026250,11
"1791",3,"TORNADO","DE",0,280000,0,1,280000,1
"1792",3,"TORNADO","FL",1e+05,306812580,28,434,306912580,462
"1793",3,"TORNADO","GA",2585000,1895956280,46,1031,1898541280,1077
"1794",3,"TORNADO","HI",0,335310,0,1,335310,1
"1795",3,"TORNADO","IA",0,140325310,0,43,140325310,43
"1796",3,"TORNADO","ID",0,287750,0,0,287750,0
"1797",3,"TORNADO","IL",0,156689590,4,283,156689590,287
"1798",3,"TORNADO","IN",0,99966530,8,179,99966530,187
"1799",3,"TORNADO","KS",55000,269406680,5,108,269461680,113
"1800",3,"TORNADO","KY",0,86712000,7,187,86712000,194
"1801",3,"TORNADO","LA",10000,96717060,5,216,96727060,221
"1802",3,"TORNADO","MA",0,25000,0,0,25000,0
"1803",3,"TORNADO","MD",0,580000,0,0,580000,0
"1804",3,"TORNADO","MI",50000,70058310,3,106,70108310,109
"1805",3,"TORNADO","MN",0,236417500,3,24,236417500,27
"1806",3,"TORNADO","MO",0,202805340,34,346,202805340,380
"1807",3,"TORNADO","MS",1655000,192553280,79,974,194208280,1053
"1808",3,"TORNADO","MT",0,25250,0,0,25250,0
"1809",3,"TORNADO","NC",140000,441606060,48,1061,441746060,1109
"1810",3,"TORNADO","NE",0,238639280,0,20,238639280,20
"1811",3,"TORNADO","NJ",0,1350000,0,10,1350000,10
"1812",3,"TORNADO","NM",250000,22550280,2,45,22800280,47
"1813",3,"TORNADO","NV",0,250000,0,0,250000,0
"1814",3,"TORNADO","NY",0,25000,0,0,25000,0
"1815",3,"TORNADO","OH",0,50705000,4,66,50705000,70
"1816",3,"TORNADO","OK",0,83914380,10,301,83914380,311
"1817",3,"TORNADO","OR",0,28000,0,0,28000,0
"1818",3,"TORNADO","PA",0,8358250,1,3,8358250,4
"1819",3,"TORNADO","SC",5047000,255251340,26,553,260298340,579
"1820",3,"TORNADO","SD",0,282500,0,1,282500,1
"1821",3,"TORNADO","TN",0,141421260,77,580,141421260,657
"1822",3,"TORNADO","TX",131500,104168940,41,573,104300440,614
"1823",3,"TORNADO","UT",0,2750,0,0,2750,0
"1824",3,"TORNADO","VA",0,5142500,1,24,5142500,25
"1825",3,"TORNADO","VT",0,25000,0,0,25000,0
"1826",3,"TORNADO","WA",0,27500,0,0,27500,0
"1827",3,"TORNADO","WI",0,18420000,1,25,18420000,26
"1828",3,"TORNADO","WV",0,815000,0,5,815000,5
"1829",3,"TROPICAL STORM","GU",10000,0,0,0,10000,0
"1830",3,"TSUNAMI","CA",0,31854000,1,0,31854000,1
"1831",3,"TSUNAMI","HI",0,14200000,0,0,14200000,0
"1832",3,"TSUNAMI","OR",0,7500000,0,0,7500000,0
"1833",3,"WATERSPOUT","FL",0,550000,1,0,550000,1
"1834",3,"WATERSPOUT","LA",0,20000,2,0,20000,2
"1835",3,"WATERSPOUT","MS",0,500,0,0,500,0
"1836",3,"WILDFIRE","AK",0,1e+05,0,0,1e+05,0
"1837",3,"WILDFIRE","AL",0,3000,0,0,3000,0
"1838",3,"WILDFIRE","AR",0,3e+05,0,2,3e+05,2
"1839",3,"WILDFIRE","AZ",0,150000,0,0,150000,0
"1840",3,"WILDFIRE","CA",0,4646000,0,0,4646000,0
"1841",3,"WILDFIRE","CO",5000,53000,0,1,58000,1
"1842",3,"WILDFIRE","DE",0,5000,0,0,5000,0
"1843",3,"WILDFIRE","FL",0,1320000,0,11,1320000,11
"1844",3,"WILDFIRE","GA",0,3583250,0,0,3583250,0
"1845",3,"WILDFIRE","GU",0,120000,0,0,120000,0
"1846",3,"WILDFIRE","HI",0,200,0,2,200,2
"1847",3,"WILDFIRE","IA",0,1e+06,0,2,1e+06,2
"1848",3,"WILDFIRE","KS",0,2100000,0,0,2100000,0
"1849",3,"WILDFIRE","MD",0,0,0,2,0,2
"1850",3,"WILDFIRE","MO",0,1860000,0,1,1860000,1
"1851",3,"WILDFIRE","NC",0,2e+06,0,0,2e+06,0
"1852",3,"WILDFIRE","NJ",0,50000,0,0,50000,0
"1853",3,"WILDFIRE","NM",0,5300000,0,1,5300000,1
"1854",3,"WILDFIRE","OK",250000,15845000,1,7,16095000,8
"1855",3,"WILDFIRE","OR",0,1000,0,0,1000,0
"1856",3,"WILDFIRE","PA",0,105000,0,0,105000,0
"1857",3,"WILDFIRE","PR",1e+06,4600000,0,0,5600000,0
"1858",3,"WILDFIRE","SC",0,2550000,0,0,2550000,0
"1859",3,"WILDFIRE","SD",0,55000,1,1,55000,2
"1860",3,"WILDFIRE","TX",45462000,52719500,13,11,98181500,24
"1861",3,"WILDFIRE","VA",0,125000,0,2,125000,2
"1862",3,"WILDFIRE","VI",0,172000,0,0,172000,0
"1863",3,"WILDFIRE","WA",3000,0,0,0,3000,0
"1864",3,"WILDFIRE","WV",0,10000,0,0,10000,0
"1865",3,"WILDFIRE","WY",0,65000,0,0,65000,0
"1866",3,"WINTER STORM","AL",0,5e+09,4,0,5e+09,4
"1867",3,"WINTER STORM","AR",0,5e+06,0,0,5e+06,0
"1868",3,"WINTER STORM","AZ",0,0,11,10,0,21
"1869",3,"WINTER STORM","CA",0,2710000,4,20,2710000,24
"1870",3,"WINTER STORM","CO",0,31600000,0,1,31600000,1
"1871",3,"WINTER STORM","CT",0,1168000,0,0,1168000,0
"1872",3,"WINTER STORM","DE",0,50000,0,0,50000,0
"1873",3,"WINTER STORM","FL",0,1020000,0,0,1020000,0
"1874",3,"WINTER STORM","IA",0,850000,0,0,850000,0
"1875",3,"WINTER STORM","IL",0,40000,3,0,40000,3
"1876",3,"WINTER STORM","KS",0,2740000,2,10,2740000,12
"1877",3,"WINTER STORM","MA",0,2606500,0,0,2606500,0
"1878",3,"WINTER STORM","MD",0,120000,1,1,120000,2
"1879",3,"WINTER STORM","MI",0,1648000,1,2,1648000,3
"1880",3,"WINTER STORM","MN",0,150000,0,0,150000,0
"1881",3,"WINTER STORM","MO",0,310000,0,0,310000,0
"1882",3,"WINTER STORM","MT",0,5015000,0,0,5015000,0
"1883",3,"WINTER STORM","NC",0,5e+07,2,10,5e+07,12
"1884",3,"WINTER STORM","ND",0,15000,0,4,15000,4
"1885",3,"WINTER STORM","NE",0,3005000,3,6,3005000,9
"1886",3,"WINTER STORM","NH",0,10000,0,0,10000,0
"1887",3,"WINTER STORM","NM",0,2e+05,0,0,2e+05,0
"1888",3,"WINTER STORM","NV",0,150000,2,0,150000,2
"1889",3,"WINTER STORM","NY",0,10108000,0,0,10108000,0
"1890",3,"WINTER STORM","OH",0,775095000,1,0,775095000,1
"1891",3,"WINTER STORM","OR",0,0,1,0,0,1
"1892",3,"WINTER STORM","PA",0,3480000,0,2,3480000,2
"1893",3,"WINTER STORM","RI",0,290000,0,0,290000,0
"1894",3,"WINTER STORM","SD",0,280000,0,3,280000,3
"1895",3,"WINTER STORM","TN",5e+06,5e+05,1,2,5500000,3
"1896",3,"WINTER STORM","TX",0,50000,0,0,50000,0
"1897",3,"WINTER STORM","UT",10000,2315000,7,126,2325000,133
"1898",3,"WINTER STORM","VA",0,10521000,0,0,10521000,0
"1899",3,"WINTER STORM","VT",70000,5804000,0,1,5874000,1
"1900",3,"WINTER STORM","WV",0,50000,0,0,50000,0
"1901",3,"WINTER STORM","WY",0,75000,0,19,75000,19
"1902",3,"WINTER WEATHER","AR",0,10000,0,1,10000,1
"1903",3,"WINTER WEATHER","AZ",0,0,0,53,0,53
"1904",3,"WINTER WEATHER","CA",0,310000,2,18,310000,20
"1905",3,"WINTER WEATHER","IA",0,22000,0,0,22000,0
"1906",3,"WINTER WEATHER","IL",0,12000,0,0,12000,0
"1907",3,"WINTER WEATHER","KS",0,67000,0,0,67000,0
"1908",3,"WINTER WEATHER","MN",0,10000,0,0,10000,0
"1909",3,"WINTER WEATHER","MO",0,4000,0,0,4000,0
"1910",3,"WINTER WEATHER","NY",0,81000,0,0,81000,0
"1911",3,"WINTER WEATHER","OK",0,10000,0,0,10000,0
"1912",3,"WINTER WEATHER","TN",0,0,1,0,0,1
"1913",3,"WINTER WEATHER","TX",0,195000,0,0,195000,0
"1914",3,"WINTER WEATHER","VT",0,238000,1,0,238000,1
"1915",3,"WINTER WEATHER","WA",0,5000,0,0,5000,0
"1916",3,"WINTER WEATHER","WI",0,302000,0,0,302000,0
"1917",4,"AVALANCHE","AK",0,13000,10,5,13000,15
"1918",4,"AVALANCHE","CA",0,0,2,0,0,2
"1919",4,"AVALANCHE","CO",0,0,2,1,0,3
"1920",4,"AVALANCHE","ID",0,0,1,0,0,1
"1921",4,"AVALANCHE","UT",0,0,3,0,0,3
"1922",4,"AVALANCHE","WA",0,0,1,4,0,5
"1923",4,"AVALANCHE","WY",0,0,2,0,0,2
"1924",4,"BLIZZARD","CA",0,30000,0,0,30000,0
"1925",4,"BLIZZARD","CO",0,7350000,0,0,7350000,0
"1926",4,"BLIZZARD","ID",0,230000,0,0,230000,0
"1927",4,"BLIZZARD","KS",0,437000,0,0,437000,0
"1928",4,"BLIZZARD","MI",0,14000,0,0,14000,0
"1929",4,"BLIZZARD","MN",0,2.5e+07,0,3,2.5e+07,3
"1930",4,"BLIZZARD","MT",0,1e+05,0,0,1e+05,0
"1931",4,"BLIZZARD","ND",0,147870000,3,16,147870000,19
"1932",4,"BLIZZARD","NE",0,5385000,0,0,5385000,0
"1933",4,"BLIZZARD","SD",0,5.2e+07,0,4,5.2e+07,4
"1934",4,"BLIZZARD","WY",0,5450000,0,0,5450000,0
"1935",4,"COASTAL FLOOD","DE",0,1e+05,0,0,1e+05,0
"1936",4,"COASTAL FLOOD","LA",0,129000,0,0,129000,0
"1937",4,"COASTAL FLOOD","MA",0,45000,0,0,45000,0
"1938",4,"COASTAL FLOOD","ME",0,15775000,0,0,15775000,0
"1939",4,"COASTAL FLOOD","NC",0,5e+05,0,0,5e+05,0
"1940",4,"COASTAL FLOOD","NH",0,5196000,0,0,5196000,0
"1941",4,"COASTAL FLOOD","NJ",0,2500000,0,1,2500000,1
"1942",4,"COASTAL FLOOD","NY",0,2.6e+07,0,0,2.6e+07,0
"1943",4,"COASTAL FLOOD","PA",0,250000,0,0,250000,0
"1944",4,"COASTAL FLOOD","RI",0,10000,0,0,10000,0
"1945",4,"COASTAL FLOOD","SC",0,5e+06,0,0,5e+06,0
"1946",4,"COASTAL FLOOD","TX",0,655000,0,0,655000,0
"1947",4,"COLD/WIND CHILL","CA",131010000,0,0,0,131010000,0
"1948",4,"COLD/WIND CHILL","CO",9800000,0,0,0,9800000,0
"1949",4,"COLD/WIND CHILL","IL",0,0,1,0,0,1
"1950",4,"COLD/WIND CHILL","KS",3e+06,0,0,0,3e+06,0
"1951",4,"COLD/WIND CHILL","MI",1e+05,0,0,0,1e+05,0
"1952",4,"COLD/WIND CHILL","NC",2e+05,0,0,0,2e+05,0
"1953",4,"COLD/WIND CHILL","OH",250000,0,0,0,250000,0
"1954",4,"COLD/WIND CHILL","PA",5e+07,0,0,0,5e+07,0
"1955",4,"COLD/WIND CHILL","SC",50000,0,0,0,50000,0
"1956",4,"COLD/WIND CHILL","TX",4e+05,2e+06,0,0,2400000,0
"1957",4,"COLD/WIND CHILL","UT",1e+05,0,0,0,1e+05,0
"1958",4,"COLD/WIND CHILL","VA",9e+05,15000,0,0,915000,0
"1959",4,"DEBRIS FLOW","AK",0,1000,0,0,1000,0
"1960",4,"DEBRIS FLOW","CA",2e+07,57253000,1,0,77253000,1
"1961",4,"DEBRIS FLOW","CO",0,56000,0,0,56000,0
"1962",4,"DEBRIS FLOW","ID",0,575100,0,0,575100,0
"1963",4,"DEBRIS FLOW","IL",0,550000,0,0,550000,0
"1964",4,"DEBRIS FLOW","ME",0,570000,0,0,570000,0
"1965",4,"DEBRIS FLOW","NY",0,1150000,0,0,1150000,0
"1966",4,"DEBRIS FLOW","PR",0,12000,0,0,12000,0
"1967",4,"DEBRIS FLOW","UT",0,40000,0,0,40000,0
"1968",4,"DEBRIS FLOW","WV",0,5000,0,0,5000,0
"1969",4,"DEBRIS FLOW","WY",0,237000,0,0,237000,0
"1970",4,"DENSE FOG","CA",0,1660000,0,56,1660000,56
"1971",4,"DENSE FOG","LA",0,10000,0,0,10000,0
"1972",4,"DENSE FOG","NC",0,0,1,14,0,15
"1973",4,"DENSE FOG","NV",0,10000,0,0,10000,0
"1974",4,"DROUGHT","OK",750000,1500000,0,0,2250000,0
"1975",4,"DROUGHT","TX",34300000,1.03e+08,0,0,137300000,0
"1976",4,"DUST DEVIL","AK",0,1000,0,0,1000,0
"1977",4,"DUST DEVIL","AZ",0,0,0,2,0,2
"1978",4,"DUST DEVIL","CA",0,2500,0,14,2500,14
"1979",4,"DUST DEVIL","CO",0,2000,0,0,2000,0
"1980",4,"DUST DEVIL","FL",0,5000,0,0,5000,0
"1981",4,"DUST DEVIL","ME",0,10000,0,0,10000,0
"1982",4,"DUST DEVIL","MI",0,30,0,0,30,0
"1983",4,"DUST DEVIL","NC",0,15000,0,0,15000,0
"1984",4,"DUST DEVIL","NM",0,20500,0,0,20500,0
"1985",4,"DUST DEVIL","NY",0,0,0,2,0,2
"1986",4,"DUST DEVIL","OK",0,4000,0,0,4000,0
"1987",4,"DUST DEVIL","OR",0,10000,0,0,10000,0
"1988",4,"DUST DEVIL","SC",0,2000,0,0,2000,0
"1989",4,"DUST DEVIL","SD",0,20000,0,0,20000,0
"1990",4,"DUST DEVIL","TX",0,25000,0,0,25000,0
"1991",4,"DUST DEVIL","VA",0,8000,0,0,8000,0
"1992",4,"DUST DEVIL","WI",0,1100,0,0,1100,0
"1993",4,"DUST DEVIL","WV",0,1000,0,0,1000,0
"1994",4,"DUST STORM","AZ",0,215000,10,20,215000,30
"1995",4,"DUST STORM","CA",0,210000,0,0,210000,0
"1996",4,"DUST STORM","CO",0,0,0,19,0,19
"1997",4,"DUST STORM","ID",0,0,0,8,0,8
"1998",4,"DUST STORM","IL",0,1000,0,0,1000,0
"1999",4,"DUST STORM","NV",0,10000,0,0,10000,0
"2000",4,"DUST STORM","TX",0,15000,0,0,15000,0
"2001",4,"FLASH FLOOD","AL",0,2626000,1,0,2626000,1
"2002",4,"FLASH FLOOD","AR",5000,28268300,10,0,28273300,10
"2003",4,"FLASH FLOOD","CA",0,210000,0,0,210000,0
"2004",4,"FLASH FLOOD","CO",0,28020000,0,0,28020000,0
"2005",4,"FLASH FLOOD","CT",0,1510000,0,0,1510000,0
"2006",4,"FLASH FLOOD","FL",0,608500,0,0,608500,0
"2007",4,"FLASH FLOOD","GA",0,159000,0,0,159000,0
"2008",4,"FLASH FLOOD","HI",0,0,2,0,0,2
"2009",4,"FLASH FLOOD","IA",0,1765000,0,0,1765000,0
"2010",4,"FLASH FLOOD","ID",0,5000,0,0,5000,0
"2011",4,"FLASH FLOOD","IL",775000,79061000,2,1,79836000,3
"2012",4,"FLASH FLOOD","IN",4000,1869000,0,1,1873000,1
"2013",4,"FLASH FLOOD","KS",1520000,7816100,1,1,9336100,2
"2014",4,"FLASH FLOOD","KY",5000,5041000,0,0,5046000,0
"2015",4,"FLASH FLOOD","LA",0,2271850,4,0,2271850,4
"2016",4,"FLASH FLOOD","MD",0,125000,0,0,125000,0
"2017",4,"FLASH FLOOD","ME",0,50350000,0,0,50350000,0
"2018",4,"FLASH FLOOD","MI",10000,1015000,0,0,1025000,0
"2019",4,"FLASH FLOOD","MN",0,33500,0,0,33500,0
"2020",4,"FLASH FLOOD","MO",1245000,45647500,10,3,46892500,13
"2021",4,"FLASH FLOOD","MS",1e+05,282302000,3,7,282402000,10
"2022",4,"FLASH FLOOD","NC",0,650000,0,1,650000,1
"2023",4,"FLASH FLOOD","NE",350000,478000,0,0,828000,0
"2024",4,"FLASH FLOOD","NM",1e+05,2200000,0,0,2300000,0
"2025",4,"FLASH FLOOD","NY",0,42991000,2,0,42991000,2
"2026",4,"FLASH FLOOD","OH",0,17670000,2,2,17670000,4
"2027",4,"FLASH FLOOD","OK",0,2672000,3,0,2672000,3
"2028",4,"FLASH FLOOD","OR",0,177000,0,0,177000,0
"2029",4,"FLASH FLOOD","PA",0,12470500,0,0,12470500,0
"2030",4,"FLASH FLOOD","PR",320000,28498000,4,0,28818000,4
"2031",4,"FLASH FLOOD","SC",0,480000,0,0,480000,0
"2032",4,"FLASH FLOOD","SD",0,25000,0,0,25000,0
"2033",4,"FLASH FLOOD","TN",0,1538500,1,0,1538500,1
"2034",4,"FLASH FLOOD","TX",725000,42730000,12,5,43455000,17
"2035",4,"FLASH FLOOD","VA",0,837000,0,0,837000,0
"2036",4,"FLASH FLOOD","VT",0,2055500,0,0,2055500,0
"2037",4,"FLASH FLOOD","WA",0,60000,0,0,60000,0
"2038",4,"FLASH FLOOD","WI",750000,840000,0,0,1590000,0
"2039",4,"FLASH FLOOD","WV",50000,730000,1,0,780000,1
"2040",4,"FLOOD","AK",0,2035500,0,0,2035500,0
"2041",4,"FLOOD","AL",275000,172000,0,0,447000,0
"2042",4,"FLOOD","AR",1905000,44194000,3,0,46099000,3
"2043",4,"FLOOD","AS",0,50000,0,0,50000,0
"2044",4,"FLOOD","CA",6340000,13268000,0,0,19608000,0
"2045",4,"FLOOD","CO",0,25155000,0,0,25155000,0
"2046",4,"FLOOD","CT",0,815000,1,0,815000,1
"2047",4,"FLOOD","FL",0,13050500,1,0,13050500,1
"2048",4,"FLOOD","GA",0,5545000,0,0,5545000,0
"2049",4,"FLOOD","GU",0,150000,0,1,150000,1
"2050",4,"FLOOD","IA",4000,78263500,0,0,78267500,0
"2051",4,"FLOOD","ID",0,1255000,0,0,1255000,0
"2052",4,"FLOOD","IL",620000,67059250,1,0,67679250,1
"2053",4,"FLOOD","IN",52000,6467000,1,0,6519000,1
"2054",4,"FLOOD","KS",2555000,23705000,3,0,26260000,3
"2055",4,"FLOOD","KY",131000,3009000,1,0,3140000,1
"2056",4,"FLOOD","LA",0,1193400,0,0,1193400,0
"2057",4,"FLOOD","MA",0,2425000,0,0,2425000,0
"2058",4,"FLOOD","MD",0,30000,0,0,30000,0
"2059",4,"FLOOD","ME",0,62712700,2,0,62712700,2
"2060",4,"FLOOD","MI",0,30891700,0,0,30891700,0
"2061",4,"FLOOD","MN",0,959645800,3,1,959645800,4
"2062",4,"FLOOD","MO",7550000,18300000,0,0,25850000,0
"2063",4,"FLOOD","MS",0,537000,2,0,537000,2
"2064",4,"FLOOD","MT",0,80000,0,0,80000,0
"2065",4,"FLOOD","NC",0,852000,0,0,852000,0
"2066",4,"FLOOD","ND",0,3424554000,2,4,3424554000,6
"2067",4,"FLOOD","NE",50000,1155000,0,0,1205000,0
"2068",4,"FLOOD","NH",0,10655000,0,0,10655000,0
"2069",4,"FLOOD","NJ",0,181750000,3,0,181750000,3
"2070",4,"FLOOD","NM",0,5000,0,0,5000,0
"2071",4,"FLOOD","NV",0,30000,0,1,30000,1
"2072",4,"FLOOD","NY",15000,163462390,6,2,163477390,8
"2073",4,"FLOOD","OH",0,15309000,1,0,15309000,1
"2074",4,"FLOOD","OK",0,2259000,1,1,2259000,2
"2075",4,"FLOOD","PA",0,130215500,1,0,130215500,1
"2076",4,"FLOOD","PR",0,136000,0,0,136000,0
"2077",4,"FLOOD","RI",0,65000,0,0,65000,0
"2078",4,"FLOOD","SC",0,125000,0,1,125000,1
"2079",4,"FLOOD","SD",3e+05,13690005.2,0,0,13990005.2,0
"2080",4,"FLOOD","TN",1017000,1149000,4,0,2166000,4
"2081",4,"FLOOD","TX",1250000,7449000,0,0,8699000,0
"2082",4,"FLOOD","UT",0,130500,0,0,130500,0
"2083",4,"FLOOD","VA",0,27000,2,1,27000,3
"2084",4,"FLOOD","VT",0,26706000,1,0,26706000,1
"2085",4,"FLOOD","WA",0,70000,0,0,70000,0
"2086",4,"FLOOD","WI",1850000,28287000,0,0,30137000,0
"2087",4,"FLOOD","WV",0,3375000,0,0,3375000,0
"2088",4,"FLOOD","WY",0,20000,0,0,20000,0
"2089",4,"FREEZING FOG","IA",0,50000,0,0,50000,0
"2090",4,"FREEZING FOG","NE",0,5000,0,0,5000,0
"2091",4,"FROST/FREEZE","AK",0,5000,0,0,5000,0
"2092",4,"FROST/FREEZE","AR",3e+05,0,0,0,3e+05,0
"2093",4,"FROST/FREEZE","CA",31900000,0,0,0,31900000,0
"2094",4,"FROST/FREEZE","CO",28545000,0,0,0,28545000,0
"2095",4,"FROST/FREEZE","GA",160500000,0,0,0,160500000,0
"2096",4,"FROST/FREEZE","IA",0,50000,0,0,50000,0
"2097",4,"FROST/FREEZE","ID",5e+06,0,0,0,5e+06,0
"2098",4,"FROST/FREEZE","IL",3020000,0,0,0,3020000,0
"2099",4,"FROST/FREEZE","IN",2630000,0,0,0,2630000,0
"2100",4,"FROST/FREEZE","KS",4250000,0,0,0,4250000,0
"2101",4,"FROST/FREEZE","KY",4485000,0,0,0,4485000,0
"2102",4,"FROST/FREEZE","MD",1480000,0,0,0,1480000,0
"2103",4,"FROST/FREEZE","MN",0,2e+05,0,0,2e+05,0
"2104",4,"FROST/FREEZE","MO",3336000,0,0,0,3336000,0
"2105",4,"FROST/FREEZE","NC",2012000,0,0,0,2012000,0
"2106",4,"FROST/FREEZE","NE",50000,0,0,0,50000,0
"2107",4,"FROST/FREEZE","OH",540000,0,0,0,540000,0
"2108",4,"FROST/FREEZE","SC",1e+06,0,0,0,1e+06,0
"2109",4,"FROST/FREEZE","VA",22916000,0,0,0,22916000,0
"2110",4,"FROST/FREEZE","WA",2.05e+08,0,0,0,2.05e+08,0
"2111",4,"FROST/FREEZE","WV",9380000,0,0,0,9380000,0
"2112",4,"FUNNEL CLOUD","TN",0,40000,0,0,40000,0
"2113",4,"HAIL","AL",389000,9236750,0,1,9625750,1
"2114",4,"HAIL","AR",30000,14535960,0,1,14565960,1
"2115",4,"HAIL","CA",79338000,130000,1,13,79468000,14
"2116",4,"HAIL","CO",50000,100250,0,0,150250,0
"2117",4,"HAIL","DE",0,120000,0,0,120000,0
"2118",4,"HAIL","FL",50000,175250,0,0,225250,0
"2119",4,"HAIL","GA",132000,54259650,0,0,54391650,0
"2120",4,"HAIL","IA",800,19243500,0,6,19244300,6
"2121",4,"HAIL","ID",0,120000,0,0,120000,0
"2122",4,"HAIL","IL",0,18418600,0,0,18418600,0
"2123",4,"HAIL","IN",0,2351500,0,0,2351500,0
"2124",4,"HAIL","KS",3684500,89232295,0,0,92916795,0
"2125",4,"HAIL","KY",13000,511052100,0,2,511065100,2
"2126",4,"HAIL","LA",504000,101084550,0,0,101588550,0
"2127",4,"HAIL","MA",0,7000,0,0,7000,0
"2128",4,"HAIL","MD",0,77000,0,0,77000,0
"2129",4,"HAIL","MI",270000,204468000,0,1,204738000,1
"2130",4,"HAIL","MN",0,738500,0,0,738500,0
"2131",4,"HAIL","MO",283000,1080382910,0,1,1080665910,1
"2132",4,"HAIL","MS",7032000,25902240,0,0,32934240,0
"2133",4,"HAIL","MT",0,5000,0,0,5000,0
"2134",4,"HAIL","NC",0,314500,0,0,314500,0
"2135",4,"HAIL","NE",175000,506110020,0,5,506285020,5
"2136",4,"HAIL","NM",104500,2177500,0,0,2282000,0
"2137",4,"HAIL","NY",56000,986000,0,0,1042000,0
"2138",4,"HAIL","OH",150000,228103000,0,5,228253000,5
"2139",4,"HAIL","OK",10000,87453200,0,4,87463200,4
"2140",4,"HAIL","PA",0,203500,0,0,203500,0
"2141",4,"HAIL","SC",2977000,4471000,0,2,7448000,2
"2142",4,"HAIL","SD",0,1131000,0,0,1131000,0
"2143",4,"HAIL","TN",62000,3086830,0,2,3148830,2
"2144",4,"HAIL","TX",12507250,1108734700,2,29,1121241950,31
"2145",4,"HAIL","VA",0,39370000,0,0,39370000,0
"2146",4,"HAIL","WA",0,19500,0,1,19500,1
"2147",4,"HAIL","WI",1000,190347900,0,0,190348900,0
"2148",4,"HAIL","WV",5000,3325000,0,0,3330000,0
"2149",4,"HAIL","WY",0,7e+05,0,0,7e+05,0
"2150",4,"HEAT","CA",0,0,0,1,0,1
"2151",4,"HEAT","MO",0,0,4,0,0,4
"2152",4,"HEAT","PA",0,0,1,0,0,1
"2153",4,"HEAT","WI",0,0,1,0,0,1
"2154",4,"HEAVY RAIN","AL",0,5e+06,0,0,5e+06,0
"2155",4,"HEAVY RAIN","CA",76410000,2175500,0,2,78585500,2
"2156",4,"HEAVY RAIN","GU",0,2e+06,19,8,2e+06,27
"2157",4,"HEAVY RAIN","IA",0,1e+05,0,0,1e+05,0
"2158",4,"HEAVY RAIN","IL",0,190000,0,0,190000,0
"2159",4,"HEAVY RAIN","IN",1000,21500,0,0,22500,0
"2160",4,"HEAVY RAIN","KS",150000,155000,0,0,305000,0
"2161",4,"HEAVY RAIN","KY",0,3000,0,0,3000,0
"2162",4,"HEAVY RAIN","MO",0,22000,0,0,22000,0
"2163",4,"HEAVY RAIN","NE",350000,125000,0,0,475000,0
"2164",4,"HEAVY RAIN","NY",0,105000,0,0,105000,0
"2165",4,"HEAVY RAIN","OH",0,17000,0,0,17000,0
"2166",4,"HEAVY RAIN","OK",0,1e+06,0,0,1e+06,0
"2167",4,"HEAVY RAIN","PR",1e+05,205500,2,0,305500,2
"2168",4,"HEAVY RAIN","TN",0,2000,1,0,2000,1
"2169",4,"HEAVY RAIN","TX",0,337000,0,0,337000,0
"2170",4,"HEAVY RAIN","VA",0,25000,0,0,25000,0
"2171",4,"HEAVY RAIN","VT",0,50000,0,0,50000,0
"2172",4,"HEAVY RAIN","WA",0,350000,0,14,350000,14
"2173",4,"HEAVY RAIN","WI",0,3000,0,0,3000,0
"2174",4,"HEAVY RAIN","WV",0,10000,0,0,10000,0
"2175",4,"HEAVY SNOW","AK",0,50000,0,0,50000,0
"2176",4,"HEAVY SNOW","CA",0,5e+05,8,17,5e+05,25
"2177",4,"HEAVY SNOW","CO",0,30000,2,0,30000,2
"2178",4,"HEAVY SNOW","CT",0,1e+06,0,0,1e+06,0
"2179",4,"HEAVY SNOW","IA",0,1775000,0,0,1775000,0
"2180",4,"HEAVY SNOW","ID",0,10000,2,0,10000,2
"2181",4,"HEAVY SNOW","IL",0,0,0,9,0,9
"2182",4,"HEAVY SNOW","KS",0,707000,8,0,707000,8
"2183",4,"HEAVY SNOW","MA",0,10010000,0,1,10010000,1
"2184",4,"HEAVY SNOW","MI",0,57000,0,0,57000,0
"2185",4,"HEAVY SNOW","MO",0,9800000,0,2,9800000,2
"2186",4,"HEAVY SNOW","MT",0,1805000,0,0,1805000,0
"2187",4,"HEAVY SNOW","ND",0,50000,0,0,50000,0
"2188",4,"HEAVY SNOW","NE",0,5e+05,0,0,5e+05,0
"2189",4,"HEAVY SNOW","NH",0,20000,0,1,20000,1
"2190",4,"HEAVY SNOW","NJ",0,0,0,4,0,4
"2191",4,"HEAVY SNOW","NV",0,860000,1,1,860000,2
"2192",4,"HEAVY SNOW","NY",1e+05,5726000,0,2,5826000,2
"2193",4,"HEAVY SNOW","OH",0,50000,0,0,50000,0
"2194",4,"HEAVY SNOW","OR",0,5000,0,2,5000,2
"2195",4,"HEAVY SNOW","PA",0,285000,0,0,285000,0
"2196",4,"HEAVY SNOW","RI",0,7e+05,0,0,7e+05,0
"2197",4,"HEAVY SNOW","SD",10000,2075000,0,68,2085000,68
"2198",4,"HEAVY SNOW","TN",0,11000,0,0,11000,0
"2199",4,"HEAVY SNOW","TX",3e+06,0,0,0,3e+06,0
"2200",4,"HEAVY SNOW","UT",6700,207000,1,13,213700,14
"2201",4,"HEAVY SNOW","VT",0,135000,0,0,135000,0
"2202",4,"HEAVY SNOW","WY",0,0,0,1,0,1
"2203",4,"HIGH SURF","CA",0,402500,5,18,402500,23
"2204",4,"HIGH SURF","FL",0,3e+05,2,0,3e+05,2
"2205",4,"HIGH SURF","PR",0,5000,1,0,5000,1
"2206",4,"HIGH WIND","AK",0,555500,0,2,555500,2
"2207",4,"HIGH WIND","AL",0,2015000,1,0,2015000,1
"2208",4,"HIGH WIND","AR",0,184000,1,5,184000,6
"2209",4,"HIGH WIND","AZ",0,395000,2,0,395000,2
"2210",4,"HIGH WIND","CA",361700,1143500,1,23,1505200,24
"2211",4,"HIGH WIND","CO",0,29348500,1,7,29348500,8
"2212",4,"HIGH WIND","CT",0,0,1,2,0,3
"2213",4,"HIGH WIND","DC",0,10000,0,0,10000,0
"2214",4,"HIGH WIND","DE",0,20000,0,0,20000,0
"2215",4,"HIGH WIND","FL",0,555000,0,0,555000,0
"2216",4,"HIGH WIND","GA",0,3401000,0,1,3401000,1
"2217",4,"HIGH WIND","HI",50000,0,0,1,50000,1
"2218",4,"HIGH WIND","IA",0,29124670,0,14,29124670,14
"2219",4,"HIGH WIND","ID",0,4904000,0,0,4904000,0
"2220",4,"HIGH WIND","IL",0,2161500,1,3,2161500,4
"2221",4,"HIGH WIND","IN",0,21500,0,3,21500,3
"2222",4,"HIGH WIND","KS",0,7177070,0,8,7177070,8
"2223",4,"HIGH WIND","KY",0,528200,3,3,528200,6
"2224",4,"HIGH WIND","LA",4e+05,437000,1,4,837000,5
"2225",4,"HIGH WIND","MA",0,290020,0,0,290020,0
"2226",4,"HIGH WIND","MD",0,255000,0,1,255000,1
"2227",4,"HIGH WIND","ME",0,315000,1,6,315000,7
"2228",4,"HIGH WIND","MI",0,7431000,0,4,7431000,4
"2229",4,"HIGH WIND","MN",0,8361880,0,0,8361880,0
"2230",4,"HIGH WIND","MO",0,878500,0,1,878500,1
"2231",4,"HIGH WIND","MS",335000,4462000,1,3,4797000,4
"2232",4,"HIGH WIND","MT",0,885300,0,3,885300,3
"2233",4,"HIGH WIND","NC",30000,3260000,3,2,3290000,5
"2234",4,"HIGH WIND","ND",0,160000,0,11,160000,11
"2235",4,"HIGH WIND","NE",0,1026000,2,4,1026000,6
"2236",4,"HIGH WIND","NH",0,7e+05,0,1,7e+05,1
"2237",4,"HIGH WIND","NJ",0,540000,0,0,540000,0
"2238",4,"HIGH WIND","NM",0,2052000,0,17,2052000,17
"2239",4,"HIGH WIND","NV",0,1764200,0,8,1764200,8
"2240",4,"HIGH WIND","NY",0,2033000,0,0,2033000,0
"2241",4,"HIGH WIND","OH",0,23122000,1,10,23122000,11
"2242",4,"HIGH WIND","OK",0,427140,0,0,427140,0
"2243",4,"HIGH WIND","OR",0,86000,0,0,86000,0
"2244",4,"HIGH WIND","PA",0,1302000,0,0,1302000,0
"2245",4,"HIGH WIND","RI",0,1e+05,0,0,1e+05,0
"2246",4,"HIGH WIND","SC",0,595000,1,0,595000,1
"2247",4,"HIGH WIND","SD",0,1330170,0,2,1330170,2
"2248",4,"HIGH WIND","TN",0,1237150,1,4,1237150,5
"2249",4,"HIGH WIND","TX",5e+05,3865010,1,3,4365010,4
"2250",4,"HIGH WIND","UT",216200,18133500,0,31,18349700,31
"2251",4,"HIGH WIND","VA",0,1148500,0,0,1148500,0
"2252",4,"HIGH WIND","VT",0,1800000,0,0,1800000,0
"2253",4,"HIGH WIND","WA",0,11418000,0,2,11418000,2
"2254",4,"HIGH WIND","WI",0,3266700,2,6,3266700,8
"2255",4,"HIGH WIND","WV",0,365000,1,2,365000,3
"2256",4,"HIGH WIND","WY",0,164000,0,0,164000,0
"2257",4,"HURRICANE/TYPHOON","GU",1100000,13900000,0,0,1.5e+07,0
"2258",4,"ICE STORM","IA",0,103000,0,0,103000,0
"2259",4,"ICE STORM","MD",0,1e+05,0,0,1e+05,0
"2260",4,"ICE STORM","MI",0,166010000,1,2,166010000,3
"2261",4,"ICE STORM","MN",0,22220020,0,0,22220020,0
"2262",4,"ICE STORM","ND",0,9.6e+07,0,0,9.6e+07,0
"2263",4,"ICE STORM","NE",0,125000,2,3,125000,5
"2264",4,"ICE STORM","NY",8550000,57050000,1,0,65600000,1
"2265",4,"LAKE-EFFECT SNOW","NY",0,35000,0,0,35000,0
"2266",4,"LAKE-EFFECT SNOW","OH",0,225000,0,0,225000,0
"2267",4,"LAKE-EFFECT SNOW","PA",0,25000,0,0,25000,0
"2268",4,"LAKESHORE FLOOD","NY",0,10000,0,0,10000,0
"2269",4,"LAKESHORE FLOOD","VT",0,20000,0,0,20000,0
"2270",4,"LIGHTNING","AL",0,8257500,0,5,8257500,5
"2271",4,"LIGHTNING","AR",0,6304000,1,5,6304000,6
"2272",4,"LIGHTNING","AS",0,0,1,1,0,2
"2273",4,"LIGHTNING","AZ",0,1000,0,0,1000,0
"2274",4,"LIGHTNING","CA",4e+05,227000,0,1,627000,1
"2275",4,"LIGHTNING","CO",0,416500,1,4,416500,5
"2276",4,"LIGHTNING","CT",0,0,0,1,0,1
"2277",4,"LIGHTNING","DE",0,166500,0,0,166500,0
"2278",4,"LIGHTNING","FL",0,420000,5,18,420000,23
"2279",4,"LIGHTNING","GA",0,4544000,1,2,4544000,3
"2280",4,"LIGHTNING","IA",0,1261000,1,5,1261000,6
"2281",4,"LIGHTNING","ID",0,1000,0,0,1000,0
"2282",4,"LIGHTNING","IL",0,2425000,1,4,2425000,5
"2283",4,"LIGHTNING","IN",0,1813000,2,2,1813000,4
"2284",4,"LIGHTNING","KS",0,1539250,1,2,1539250,3
"2285",4,"LIGHTNING","KY",0,48000,0,7,48000,7
"2286",4,"LIGHTNING","LA",0,6475600,2,24,6475600,26
"2287",4,"LIGHTNING","MA",0,875000,0,1,875000,1
"2288",4,"LIGHTNING","MD",0,1436000,0,2,1436000,2
"2289",4,"LIGHTNING","ME",0,83000,0,0,83000,0
"2290",4,"LIGHTNING","MI",0,702500,0,14,702500,14
"2291",4,"LIGHTNING","MN",0,25000,0,3,25000,3
"2292",4,"LIGHTNING","MO",0,880800,1,9,880800,10
"2293",4,"LIGHTNING","MS",0,1329000,1,1,1329000,2
"2294",4,"LIGHTNING","MT",0,0,0,1,0,1
"2295",4,"LIGHTNING","NC",0,2631000,0,13,2631000,13
"2296",4,"LIGHTNING","ND",0,38000,0,0,38000,0
"2297",4,"LIGHTNING","NE",0,527000,1,4,527000,5
"2298",4,"LIGHTNING","NJ",0,348000,0,3,348000,3
"2299",4,"LIGHTNING","NM",0,0,0,1,0,1
"2300",4,"LIGHTNING","NV",0,25000,0,0,25000,0
"2301",4,"LIGHTNING","NY",0,957500,0,1,957500,1
"2302",4,"LIGHTNING","OH",50000,1807000,3,5,1857000,8
"2303",4,"LIGHTNING","OK",0,4090700,2,1,4090700,3
"2304",4,"LIGHTNING","OR",0,202000,0,2,202000,2
"2305",4,"LIGHTNING","PA",0,623000,0,0,623000,0
"2306",4,"LIGHTNING","RI",0,0,0,1,0,1
"2307",4,"LIGHTNING","SC",0,1361000,1,4,1361000,5
"2308",4,"LIGHTNING","SD",0,157000,0,2,157000,2
"2309",4,"LIGHTNING","TN",0,1604000,2,18,1604000,20
"2310",4,"LIGHTNING","TX",50,2805550,4,4,2805600,8
"2311",4,"LIGHTNING","UT",0,1e+05,0,0,1e+05,0
"2312",4,"LIGHTNING","VA",2500,1641500,1,0,1644000,1
"2313",4,"LIGHTNING","VT",0,74000,0,0,74000,0
"2314",4,"LIGHTNING","WA",0,36000,1,1,36000,2
"2315",4,"LIGHTNING","WI",3000,451250,0,6,454250,6
"2316",4,"LIGHTNING","WV",0,250000,0,11,250000,11
"2317",4,"LIGHTNING","WY",0,0,0,1,0,1
"2318",4,"MARINE HIGH WIND","GM",0,20010,0,0,20010,0
"2319",4,"MARINE STRONG WIND","GM",0,130,0,0,130,0
"2320",4,"MARINE STRONG WIND","PZ",0,25000,1,1,25000,2
"2321",4,"MARINE THUNDERSTORM WIND","AM",0,0,2,1,0,3
"2322",4,"MARINE THUNDERSTORM WIND","GM",0,36000,0,0,36000,0
"2323",4,"OTHER EVENT NON IDENTIFIED","OH",0,150000,0,0,150000,0
"2324",4,"RIP CURRENT","AL",0,0,4,0,0,4
"2325",4,"RIP CURRENT","AS",0,20000,0,1,20000,1
"2326",4,"RIP CURRENT","CA",0,0,2,1,0,3
"2327",4,"RIP CURRENT","FL",0,0,28,21,0,49
"2328",4,"RIP CURRENT","GU",0,0,5,4,0,9
"2329",4,"RIP CURRENT","NY",0,0,1,0,0,1
"2330",4,"RIP CURRENT","PR",0,0,4,0,0,4
"2331",4,"RIP CURRENT","SC",0,0,2,0,0,2
"2332",4,"RIP CURRENT","TX",0,0,3,0,0,3
"2333",4,"STORM SURGE/TIDE","ME",0,2e+05,0,0,2e+05,0
"2334",4,"STORM SURGE/TIDE","NC",0,90000,0,0,90000,0
"2335",4,"STORM SURGE/TIDE","OH",0,3700000,0,0,3700000,0
"2336",4,"STRONG WIND","AL",0,1056600,0,3,1056600,3
"2337",4,"STRONG WIND","AR",0,52000,1,1,52000,2
"2338",4,"STRONG WIND","AS",4000,0,0,0,4000,0
"2339",4,"STRONG WIND","AZ",0,74000,0,0,74000,0
"2340",4,"STRONG WIND","CA",3000,565000,0,0,568000,0
"2341",4,"STRONG WIND","CO",1000,326100,0,0,327100,0
"2342",4,"STRONG WIND","CT",0,377000,0,0,377000,0
"2343",4,"STRONG WIND","DC",0,0,0,2,0,2
"2344",4,"STRONG WIND","DE",0,35920,0,0,35920,0
"2345",4,"STRONG WIND","FL",0,68100,0,5,68100,5
"2346",4,"STRONG WIND","GA",0,554450,1,15,554450,16
"2347",4,"STRONG WIND","IA",0,6000,0,0,6000,0
"2348",4,"STRONG WIND","ID",0,35000,0,0,35000,0
"2349",4,"STRONG WIND","IL",0,30000,0,1,30000,1
"2350",4,"STRONG WIND","IN",0,73000,0,0,73000,0
"2351",4,"STRONG WIND","KS",0,30000,0,0,30000,0
"2352",4,"STRONG WIND","KY",0,20000,0,1,20000,1
"2353",4,"STRONG WIND","LA",0,116000,0,0,116000,0
"2354",4,"STRONG WIND","MA",0,218000,0,3,218000,3
"2355",4,"STRONG WIND","MD",0,36900,0,0,36900,0
"2356",4,"STRONG WIND","MI",0,53000,1,0,53000,1
"2357",4,"STRONG WIND","MO",0,14000,1,0,14000,1
"2358",4,"STRONG WIND","MS",0,194000,0,0,194000,0
"2359",4,"STRONG WIND","MT",0,35000,0,0,35000,0
"2360",4,"STRONG WIND","NC",121000,172000,0,0,293000,0
"2361",4,"STRONG WIND","NE",0,65000,0,0,65000,0
"2362",4,"STRONG WIND","NH",0,25000,0,0,25000,0
"2363",4,"STRONG WIND","NJ",0,71700,0,1,71700,1
"2364",4,"STRONG WIND","NM",0,68500,0,0,68500,0
"2365",4,"STRONG WIND","NV",0,214600,1,2,214600,3
"2366",4,"STRONG WIND","NY",0,89000,0,2,89000,2
"2367",4,"STRONG WIND","OH",0,41000,0,0,41000,0
"2368",4,"STRONG WIND","OK",0,1000,0,0,1000,0
"2369",4,"STRONG WIND","OR",0,30000,0,0,30000,0
"2370",4,"STRONG WIND","PA",0,75500,0,2,75500,2
"2371",4,"STRONG WIND","PR",0,12000,0,0,12000,0
"2372",4,"STRONG WIND","RI",0,60000,0,0,60000,0
"2373",4,"STRONG WIND","SC",1000,30000,3,2,31000,5
"2374",4,"STRONG WIND","TN",0,131000,1,2,131000,3
"2375",4,"STRONG WIND","TX",0,403200,1,3,403200,4
"2376",4,"STRONG WIND","UT",0,135500,0,4,135500,4
"2377",4,"STRONG WIND","VA",0,136000,1,6,136000,7
"2378",4,"STRONG WIND","VT",0,67000,0,0,67000,0
"2379",4,"STRONG WIND","WA",0,59000,0,0,59000,0
"2380",4,"STRONG WIND","WI",0,294750,1,1,294750,2
"2381",4,"STRONG WIND","WV",0,5000,0,0,5000,0
"2382",4,"THUNDERSTORM WIND","AL",3264000,16327550,5,71,19591550,76
"2383",4,"THUNDERSTORM WIND","AR",0,17892400,7,30,17892400,37
"2384",4,"THUNDERSTORM WIND","AZ",0,28000,0,0,28000,0
"2385",4,"THUNDERSTORM WIND","CA",1e+05,1791000,1,1,1891000,2
"2386",4,"THUNDERSTORM WIND","CO",0,1028500,1,1,1028500,2
"2387",4,"THUNDERSTORM WIND","CT",0,10550.1,0,2,10550.1,2
"2388",4,"THUNDERSTORM WIND","DC",0,520000,1,3,520000,4
"2389",4,"THUNDERSTORM WIND","DE",0,170000,0,0,170000,0
"2390",4,"THUNDERSTORM WIND","FL",39000,14223400,3,41,14262400,44
"2391",4,"THUNDERSTORM WIND","GA",167500,44417805,7,49,44585305,56
"2392",4,"THUNDERSTORM WIND","IA",0,21729800,1,45,21729800,46
"2393",4,"THUNDERSTORM WIND","ID",0,1378000,3,0,1378000,3
"2394",4,"THUNDERSTORM WIND","IL",0,37276600,0,45,37276600,45
"2395",4,"THUNDERSTORM WIND","IN",0,19417457,2,14,19417457,16
"2396",4,"THUNDERSTORM WIND","KS",88000,31138200,1,12,31226200,13
"2397",4,"THUNDERSTORM WIND","KY",20000,19927110,1,46,19947110,47
"2398",4,"THUNDERSTORM WIND","LA",155000,29335950,4,19,29490950,23
"2399",4,"THUNDERSTORM WIND","MA",0,66050,0,0,66050,0
"2400",4,"THUNDERSTORM WIND","MD",0,469000,0,6,469000,6
"2401",4,"THUNDERSTORM WIND","MI",0,3740004,0,2,3740004,2
"2402",4,"THUNDERSTORM WIND","MN",0,1406000,2,10,1406000,12
"2403",4,"THUNDERSTORM WIND","MO",17050,30511560,2,61,30528610,63
"2404",4,"THUNDERSTORM WIND","MS",330000,24016150,7,26,24346150,33
"2405",4,"THUNDERSTORM WIND","MT",0,111000,0,0,111000,0
"2406",4,"THUNDERSTORM WIND","NC",24000,5568800,3,24,5592800,27
"2407",4,"THUNDERSTORM WIND","ND",0,135000,0,2,135000,2
"2408",4,"THUNDERSTORM WIND","NE",0,4216000,0,2,4216000,2
"2409",4,"THUNDERSTORM WIND","NJ",0,350000,0,3,350000,3
"2410",4,"THUNDERSTORM WIND","NM",0,42500,1,0,42500,1
"2411",4,"THUNDERSTORM WIND","NV",0,10500,0,0,10500,0
"2412",4,"THUNDERSTORM WIND","NY",0,5136500,2,6,5136500,8
"2413",4,"THUNDERSTORM WIND","OH",1e+05,23612003,6,19,23712003,25
"2414",4,"THUNDERSTORM WIND","OK",0,15680035,1,15,15680035,16
"2415",4,"THUNDERSTORM WIND","OR",0,218000,0,0,218000,0
"2416",4,"THUNDERSTORM WIND","PA",0,9281500,0,23,9281500,23
"2417",4,"THUNDERSTORM WIND","PR",0,505000,0,0,505000,0
"2418",4,"THUNDERSTORM WIND","RI",0,25,0,0,25,0
"2419",4,"THUNDERSTORM WIND","SC",40000,5991600,0,28,6031600,28
"2420",4,"THUNDERSTORM WIND","SD",0,2097000,1,8,2097000,9
"2421",4,"THUNDERSTORM WIND","TN",334000,37672210,3,49,38006210,52
"2422",4,"THUNDERSTORM WIND","TX",1283230,158959750,2,59,160242980,61
"2423",4,"THUNDERSTORM WIND","UT",200,125050,0,0,125250,0
"2424",4,"THUNDERSTORM WIND","VA",32000,4327167,1,6,4359167,7
"2425",4,"THUNDERSTORM WIND","VT",0,45000,0,0,45000,0
"2426",4,"THUNDERSTORM WIND","WA",0,85000,0,1,85000,1
"2427",4,"THUNDERSTORM WIND","WI",0,15462050,0,3,15462050,3
"2428",4,"THUNDERSTORM WIND","WV",0,4672500,3,95,4672500,98
"2429",4,"THUNDERSTORM WIND","WY",0,85000,0,3,85000,3
"2430",4,"TORNADO","AL",6135000,4822655510,422,4271,4828790510,4693
"2431",4,"TORNADO","AR",1e+05,1061541800,67,1192,1061641800,1259
"2432",4,"TORNADO","AZ",0,2000,0,0,2000,0
"2433",4,"TORNADO","CA",180050,1751000,0,2,1931050,2
"2434",4,"TORNADO","CO",0,467090,0,0,467090,0
"2435",4,"TORNADO","CT",0,2500,0,0,2500,0
"2436",4,"TORNADO","DE",0,335000,0,3,335000,3
"2437",4,"TORNADO","FL",4000,162613310,20,736,162617310,756
"2438",4,"TORNADO","GA",1715000,508053530,67,1203,509768530,1270
"2439",4,"TORNADO","HI",0,5000,0,0,5000,0
"2440",4,"TORNADO","IA",0,129754490,10,191,129754490,201
"2441",4,"TORNADO","ID",0,3366060,0,2,3366060,2
"2442",4,"TORNADO","IL",10100,379197470,95,1725,379207570,1820
"2443",4,"TORNADO","IN",0,1823743120,190,2902,1823743120,3092
"2444",4,"TORNADO","KS",5e+05,807336210,26,469,807836210,495
"2445",4,"TORNADO","KY",506000,231392840,95,1992,231898840,2087
"2446",4,"TORNADO","LA",2e+06,168550290,18,361,170550290,379
"2447",4,"TORNADO","MD",0,126324250,3,123,126324250,126
"2448",4,"TORNADO","MI",0,382466780,77,1401,382466780,1478
"2449",4,"TORNADO","MN",0,354125500,14,150,354125500,164
"2450",4,"TORNADO","MO",1484000,451040380,19,480,452524380,499
"2451",4,"TORNADO","MS",39025000,1320723280,86,1024,1359748280,1110
"2452",4,"TORNADO","MT",0,8e+05,0,1,8e+05,1
"2453",4,"TORNADO","NC",1825000,440687500,37,691,442512500,728
"2454",4,"TORNADO","ND",0,52750,0,0,52750,0
"2455",4,"TORNADO","NE",50000,134442330,2,70,134492330,72
"2456",4,"TORNADO","NJ",0,53000,0,2,53000,2
"2457",4,"TORNADO","NM",0,486060,0,4,486060,4
"2458",4,"TORNADO","NY",0,3042500,0,1,3042500,1
"2459",4,"TORNADO","OH",3000,535502280,117,2384,535505280,2501
"2460",4,"TORNADO","OK",50000050,657698123,61,1093,707698173,1154
"2461",4,"TORNADO","OR",0,318250,0,1,318250,1
"2462",4,"TORNADO","PA",0,12434060,0,26,12434060,26
"2463",4,"TORNADO","SC",33000,55072900,4,87,55105900,91
"2464",4,"TORNADO","SD",0,9096250,0,16,9096250,16
"2465",4,"TORNADO","TN",1265000,643601030,170,2482,644866030,2652
"2466",4,"TORNADO","TX",144100,979369280,152,3241,979513380,3393
"2467",4,"TORNADO","UT",0,101250,0,2,101250,2
"2468",4,"TORNADO","VA",2e+06,118420000,13,446,120420000,459
"2469",4,"TORNADO","WA",0,25942560,6,301,25942560,307
"2470",4,"TORNADO","WI",1587000,164360550,21,315,165947550,336
"2471",4,"TORNADO","WV",15000,13016000,1,48,13031000,49
"2472",4,"TORNADO","WY",0,135250,0,1,135250,1
"2473",4,"TROPICAL STORM","GU",0,10000,2,0,10000,2
"2474",4,"WATERSPOUT","AM",0,1e+05,0,0,1e+05,0
"2475",4,"WATERSPOUT","FL",0,65000,0,3,65000,3
"2476",4,"WATERSPOUT","LA",0,5e+07,3,39,5e+07,42
"2477",4,"WATERSPOUT","MS",0,2000,0,0,2000,0
"2478",4,"WILDFIRE","AZ",0,90000,0,0,90000,0
"2479",4,"WILDFIRE","CA",0,2220000,0,3,2220000,3
"2480",4,"WILDFIRE","CO",0,5200000,0,1,5200000,1
"2481",4,"WILDFIRE","DE",0,0,0,1,0,1
"2482",4,"WILDFIRE","FL",0,11119000,0,6,11119000,6
"2483",4,"WILDFIRE","GA",0,2274200,0,10,2274200,10
"2484",4,"WILDFIRE","GU",0,35000,0,0,35000,0
"2485",4,"WILDFIRE","KS",0,150000,0,0,150000,0
"2486",4,"WILDFIRE","LA",45000,0,0,0,45000,0
"2487",4,"WILDFIRE","MI",0,1156000,0,0,1156000,0
"2488",4,"WILDFIRE","MO",0,184000,0,4,184000,4
"2489",4,"WILDFIRE","MT",0,75000,0,0,75000,0
"2490",4,"WILDFIRE","NC",0,1e+05,0,0,1e+05,0
"2491",4,"WILDFIRE","ND",0,6e+05,0,6,6e+05,6
"2492",4,"WILDFIRE","NE",0,192000,0,0,192000,0
"2493",4,"WILDFIRE","NJ",0,0,0,2,0,2
"2494",4,"WILDFIRE","NM",0,10308000,0,3,10308000,3
"2495",4,"WILDFIRE","NY",0,102000,0,0,102000,0
"2496",4,"WILDFIRE","OK",0,3566000,0,0,3566000,0
"2497",4,"WILDFIRE","PA",0,1300000,0,0,1300000,0
"2498",4,"WILDFIRE","PR",0,5000,0,0,5000,0
"2499",4,"WILDFIRE","SC",0,40025000,0,0,40025000,0
"2500",4,"WILDFIRE","TX",95138000,147838500,3,27,242976500,30
"2501",4,"WILDFIRE","VA",1592500,3952000,0,0,5544500,0
"2502",4,"WILDFIRE","VI",0,50000,0,0,50000,0
"2503",4,"WILDFIRE","WA",0,180000,0,0,180000,0
"2504",4,"WILDFIRE","WI",502000,1187000,1,3,1689000,4
"2505",4,"WILDFIRE","WY",0,1761000,0,1,1761000,1
"2506",4,"WINTER STORM","AZ",0,20000,0,0,20000,0
"2507",4,"WINTER STORM","CA",0,463000,1,4,463000,5
"2508",4,"WINTER STORM","CO",0,120000,0,0,120000,0
"2509",4,"WINTER STORM","CT",0,35000,0,0,35000,0
"2510",4,"WINTER STORM","IA",0,115000,0,0,115000,0
"2511",4,"WINTER STORM","ID",0,20000,0,0,20000,0
"2512",4,"WINTER STORM","MA",0,40000,0,0,40000,0
"2513",4,"WINTER STORM","MO",0,5e+05,0,0,5e+05,0
"2514",4,"WINTER STORM","ND",0,14850000,3,6,14850000,9
"2515",4,"WINTER STORM","NE",0,10548000,0,0,10548000,0
"2516",4,"WINTER STORM","NH",0,35000,0,0,35000,0
"2517",4,"WINTER STORM","NM",1270000,1500000,0,0,2770000,0
"2518",4,"WINTER STORM","NY",0,8e+05,0,0,8e+05,0
"2519",4,"WINTER STORM","OH",0,6250000,0,0,6250000,0
"2520",4,"WINTER STORM","PA",0,1050000,0,0,1050000,0
"2521",4,"WINTER STORM","SD",0,8005000,0,0,8005000,0
"2522",4,"WINTER STORM","TX",23000,31000,0,0,54000,0
"2523",4,"WINTER STORM","UT",3000,250000,0,57,253000,57
"2524",4,"WINTER STORM","VT",0,885000,0,0,885000,0
"2525",4,"WINTER STORM","WI",0,10000,0,0,10000,0
"2526",4,"WINTER STORM","WY",0,175000,0,0,175000,0
"2527",4,"WINTER WEATHER","CA",0,110000,0,65,110000,65
"2528",4,"WINTER WEATHER","KS",0,8000,0,0,8000,0
"2529",4,"WINTER WEATHER","MI",0,1000,0,0,1000,0
"2530",4,"WINTER WEATHER","ND",0,30000,0,0,30000,0
"2531",4,"WINTER WEATHER","NY",0,41000,0,0,41000,0
"2532",4,"WINTER WEATHER","VT",0,119000,0,0,119000,0
"2533",5,"AVALANCHE","CO",0,0,1,3,0,4
"2534",5,"AVALANCHE","OR",0,0,0,2,0,2
"2535",5,"AVALANCHE","UT",0,0,0,1,0,1
"2536",5,"AVALANCHE","WA",0,0,0,2,0,2
"2537",5,"AVALANCHE","WY",0,0,0,2,0,2
"2538",5,"BLIZZARD","WA",0,0,3,1,0,4
"2539",5,"COASTAL FLOOD","AL",0,15000,0,0,15000,0
"2540",5,"COASTAL FLOOD","FL",0,10000,0,0,10000,0
"2541",5,"COASTAL FLOOD","MD",0,125000,0,0,125000,0
"2542",5,"COASTAL FLOOD","ME",0,410000,0,0,410000,0
"2543",5,"COASTAL FLOOD","NC",0,30000,0,0,30000,0
"2544",5,"COASTAL FLOOD","NH",0,50000,0,0,50000,0
"2545",5,"COLD/WIND CHILL","CA",0,0,1,0,0,1
"2546",5,"COLD/WIND CHILL","IA",71100000,0,0,0,71100000,0
"2547",5,"COLD/WIND CHILL","MI",2e+06,0,0,0,2e+06,0
"2548",5,"COLD/WIND CHILL","NY",0,63000,0,0,63000,0
"2549",5,"COLD/WIND CHILL","OH",4e+06,0,0,0,4e+06,0
"2550",5,"COLD/WIND CHILL","PA",0,10000,0,0,10000,0
"2551",5,"DEBRIS FLOW","AK",0,50000,0,0,50000,0
"2552",5,"DEBRIS FLOW","AS",0,20000,0,0,20000,0
"2553",5,"DEBRIS FLOW","CO",0,151000,0,0,151000,0
"2554",5,"DEBRIS FLOW","NC",0,1000,0,0,1000,0
"2555",5,"DEBRIS FLOW","NY",0,501000,0,0,501000,0
"2556",5,"DEBRIS FLOW","OH",0,2000,0,0,2000,0
"2557",5,"DEBRIS FLOW","OR",0,1000,0,0,1000,0
"2558",5,"DEBRIS FLOW","PR",0,121000,0,0,121000,0
"2559",5,"DEBRIS FLOW","VA",0,15000,1,0,15000,1
"2560",5,"DEBRIS FLOW","WA",17000,1054000,0,0,1071000,0
"2561",5,"DEBRIS FLOW","WY",0,5e+05,0,0,5e+05,0
"2562",5,"DENSE FOG","CA",0,25000,0,0,25000,0
"2563",5,"DENSE FOG","FL",0,3e+05,1,0,3e+05,1
"2564",5,"DENSE FOG","KS",0,15000,0,1,15000,1
"2565",5,"DENSE FOG","VA",0,3e+05,0,0,3e+05,0
"2566",5,"DROUGHT","FL",1e+08,0,0,0,1e+08,0
"2567",5,"DROUGHT","LA",4e+06,0,0,0,4e+06,0
"2568",5,"DROUGHT","MS",2e+05,0,0,0,2e+05,0
"2569",5,"DROUGHT","MT",990000,0,0,0,990000,0
"2570",5,"DROUGHT","OK",5e+05,0,0,0,5e+05,0
"2571",5,"DROUGHT","PA",0,0,1,0,0,1
"2572",5,"DROUGHT","SC",2e+07,0,0,0,2e+07,0
"2573",5,"DROUGHT","TX",334035000,24400000,0,0,358435000,0
"2574",5,"DUST DEVIL","AK",0,1300,0,0,1300,0
"2575",5,"DUST DEVIL","AZ",0,3500,0,6,3500,6
"2576",5,"DUST DEVIL","CA",0,15000,0,0,15000,0
"2577",5,"DUST DEVIL","CO",0,6000,0,0,6000,0
"2578",5,"DUST DEVIL","IA",0,0,0,5,0,5
"2579",5,"DUST DEVIL","ME",0,0,1,0,0,1
"2580",5,"DUST DEVIL","MI",0,500,0,0,500,0
"2581",5,"DUST DEVIL","MT",0,1000,0,0,1000,0
"2582",5,"DUST DEVIL","ND",0,0,0,1,0,1
"2583",5,"DUST DEVIL","NV",0,110500,0,0,110500,0
"2584",5,"DUST DEVIL","TX",0,25000,0,0,25000,0
"2585",5,"DUST DEVIL","WA",0,3000,0,0,3000,0
"2586",5,"DUST DEVIL","WI",0,6300,0,0,6300,0
"2587",5,"DUST DEVIL","WY",0,1000,0,0,1000,0
"2588",5,"DUST STORM","AZ",0,80000,0,10,80000,10
"2589",5,"DUST STORM","CA",0,10000,0,0,10000,0
"2590",5,"DUST STORM","IN",0,50000,0,1,50000,1
"2591",5,"DUST STORM","NE",0,65000,2,17,65000,19
"2592",5,"DUST STORM","NV",0,1e+05,0,4,1e+05,4
"2593",5,"DUST STORM","OR",0,0,0,3,0,3
"2594",5,"DUST STORM","TX",0,50000,0,0,50000,0
"2595",5,"DUST STORM","WA",0,5000,0,0,5000,0
"2596",5,"FLASH FLOOD","AK",0,10020,0,0,10020,0
"2597",5,"FLASH FLOOD","AL",112000,1018151500,2,1,1018263500,3
"2598",5,"FLASH FLOOD","AR",110000,24036200,11,0,24146200,11
"2599",5,"FLASH FLOOD","AS",1e+06,50003000,4,6,51003000,10
"2600",5,"FLASH FLOOD","AZ",0,42000,0,0,42000,0
"2601",5,"FLASH FLOOD","CA",0,3710000,2,0,3710000,2
"2602",5,"FLASH FLOOD","CO",150000,2450000,0,0,2600000,0
"2603",5,"FLASH FLOOD","CT",0,620000,0,0,620000,0
"2604",5,"FLASH FLOOD","FL",10000,5138800,0,0,5148800,0
"2605",5,"FLASH FLOOD","GA",10000,27772000,2,5,27782000,7
"2606",5,"FLASH FLOOD","HI",230000,60000,0,0,290000,0
"2607",5,"FLASH FLOOD","IA",2786500,73817500,1,2,76604000,3
"2608",5,"FLASH FLOOD","ID",0,6219500,0,0,6219500,0
"2609",5,"FLASH FLOOD","IL",195000,45589100,1,7,45784100,8
"2610",5,"FLASH FLOOD","IN",118000,9364530,6,0,9482530,6
"2611",5,"FLASH FLOOD","KS",9015000,69454175,2,0,78469175,2
"2612",5,"FLASH FLOOD","KY",10050000,20509010,10,5,30559010,15
"2613",5,"FLASH FLOOD","LA",1600000,21608000,5,0,23208000,5
"2614",5,"FLASH FLOOD","MD",0,565000,0,0,565000,0
"2615",5,"FLASH FLOOD","ME",0,130000,0,0,130000,0
"2616",5,"FLASH FLOOD","MI",1810000,8703000,0,1,10513000,1
"2617",5,"FLASH FLOOD","MN",630000,5635500,0,0,6265500,0
"2618",5,"FLASH FLOOD","MO",50167000,353919912,16,7,404086912,23
"2619",5,"FLASH FLOOD","MS",2902000,27111500,1,1,30013500,2
"2620",5,"FLASH FLOOD","MT",0,218000,1,0,218000,1
"2621",5,"FLASH FLOOD","NC",5000,9015000,0,0,9020000,0
"2622",5,"FLASH FLOOD","ND",465000,2614000,0,0,3079000,0
"2623",5,"FLASH FLOOD","NE",48820000,51720202.2,0,1,100540202.2,1
"2624",5,"FLASH FLOOD","NH",0,1318000,0,0,1318000,0
"2625",5,"FLASH FLOOD","NJ",0,0,0,1,0,1
"2626",5,"FLASH FLOOD","NM",15000,336000,0,0,351000,0
"2627",5,"FLASH FLOOD","NV",0,30000,0,0,30000,0
"2628",5,"FLASH FLOOD","NY",0,25596000,0,0,25596000,0
"2629",5,"FLASH FLOOD","OH",258000,88107022,1,11,88365022,12
"2630",5,"FLASH FLOOD","OK",0,77357700,9,19,77357700,28
"2631",5,"FLASH FLOOD","OR",0,94000,0,0,94000,0
"2632",5,"FLASH FLOOD","PA",0,23569000,3,2,23569000,5
"2633",5,"FLASH FLOOD","PR",12200000,133853000,5,0,146053000,5
"2634",5,"FLASH FLOOD","RI",0,5000,0,0,5000,0
"2635",5,"FLASH FLOOD","SC",24000,62000,0,0,86000,0
"2636",5,"FLASH FLOOD","SD",5000,56765000,0,0,56770000,0
"2637",5,"FLASH FLOOD","TN",27000,302598780,10,3,302625780,13
"2638",5,"FLASH FLOOD","TX",2428500,52964000,39,33,55392500,72
"2639",5,"FLASH FLOOD","UT",0,1493000,1,0,1493000,1
"2640",5,"FLASH FLOOD","VA",0,28027500,3,0,28027500,3
"2641",5,"FLASH FLOOD","VI",0,60000,0,0,60000,0
"2642",5,"FLASH FLOOD","VT",0,9870000,0,0,9870000,0
"2643",5,"FLASH FLOOD","WA",0,669000,0,0,669000,0
"2644",5,"FLASH FLOOD","WI",4985000,4780500,1,0,9765500,1
"2645",5,"FLASH FLOOD","WV",0,123739000,11,2,123739000,13
"2646",5,"FLASH FLOOD","WY",30000,679900,0,0,709900,0
"2647",5,"FLOOD","AK",0,45540940,3,0,45540940,3
"2648",5,"FLOOD","AL",275000,5785000,0,0,6060000,0
"2649",5,"FLOOD","AR",119985000,155414000,6,0,275399000,6
"2650",5,"FLOOD","CA",0,7490000,0,0,7490000,0
"2651",5,"FLOOD","CO",3611000,4655500,0,0,8266500,0
"2652",5,"FLOOD","FL",0,68605000,0,0,68605000,0
"2653",5,"FLOOD","GA",0,552000,0,0,552000,0
"2654",5,"FLOOD","HI",0,0,0,6,0,6
"2655",5,"FLOOD","IA",25011000,60754000,0,0,85765000,0
"2656",5,"FLOOD","ID",25000,4776000,0,0,4801000,0
"2657",5,"FLOOD","IL",18308000,38033010,4,7,56341010,11
"2658",5,"FLOOD","IN",492000,7769000,0,0,8261000,0
"2659",5,"FLOOD","KS",56314000,101554800,0,1,157868800,1
"2660",5,"FLOOD","KY",948000,100458000,2,0,101406000,2
"2661",5,"FLOOD","LA",1400000,24685000,0,0,26085000,0
"2662",5,"FLOOD","MA",0,12566000,2,0,12566000,2
"2663",5,"FLOOD","MD",0,316000,0,0,316000,0
"2664",5,"FLOOD","ME",0,16926000,0,0,16926000,0
"2665",5,"FLOOD","MI",7e+06,145518000,0,0,152518000,0
"2666",5,"FLOOD","MN",1250000,11170000,0,0,12420000,0
"2667",5,"FLOOD","MO",8971000,44923000,4,0,53894000,4
"2668",5,"FLOOD","MS",2e+06,1011127000,1,0,1013127000,1
"2669",5,"FLOOD","MT",0,22511000,3,0,22511000,3
"2670",5,"FLOOD","NC",0,12000,0,0,12000,0
"2671",5,"FLOOD","ND",1375000,221677000,0,0,223052000,0
"2672",5,"FLOOD","NE",5367000,6429000,0,0,11796000,0
"2673",5,"FLOOD","NH",0,8112000,0,0,8112000,0
"2674",5,"FLOOD","NM",0,30000,1,0,30000,1
"2675",5,"FLOOD","NV",0,205000,0,0,205000,0
"2676",5,"FLOOD","NY",0,1268000,0,0,1268000,0
"2677",5,"FLOOD","OH",890000,15386007,4,0,16276007,4
"2678",5,"FLOOD","OK",5e+07,50036000,2,0,100036000,2
"2679",5,"FLOOD","OR",50000,2728000,0,0,2778000,0
"2680",5,"FLOOD","PA",0,4698000,0,2,4698000,2
"2681",5,"FLOOD","PR",0,754000,0,0,754000,0
"2682",5,"FLOOD","SC",0,501000,0,0,501000,0
"2683",5,"FLOOD","SD",3e+06,13580000,0,1,16580000,1
"2684",5,"FLOOD","TN",420000,4106942900,16,0,4107362900,16
"2685",5,"FLOOD","TX",55000,1164000,5,1,1219000,6
"2686",5,"FLOOD","UT",50000,1556000,0,8,1606000,8
"2687",5,"FLOOD","VA",0,101000,1,0,101000,1
"2688",5,"FLOOD","VI",0,5000,0,0,5000,0
"2689",5,"FLOOD","VT",0,3470000,0,0,3470000,0
"2690",5,"FLOOD","WA",0,9424000,0,0,9424000,0
"2691",5,"FLOOD","WI",2718000,10471000,0,0,13189000,0
"2692",5,"FLOOD","WV",0,46740000,2,0,46740000,2
"2693",5,"FLOOD","WY",205000,678000,0,0,883000,0
"2694",5,"FROST/FREEZE","IA",10290000,1e+06,0,0,11290000,0
"2695",5,"FROST/FREEZE","IL",26360000,0,0,0,26360000,0
"2696",5,"FROST/FREEZE","MO",2650000,0,0,0,2650000,0
"2697",5,"FROST/FREEZE","NY",120000,1e+05,0,0,220000,0
"2698",5,"FROST/FREEZE","VT",50000,0,0,0,50000,0
"2699",5,"FROST/FREEZE","WI",2000,0,0,0,2000,0
"2700",5,"FUNNEL CLOUD","KY",0,25000,0,0,25000,0
"2701",5,"FUNNEL CLOUD","TN",0,50000,0,0,50000,0
"2702",5,"HAIL","AL",331000,6279300,0,0,6610300,0
"2703",5,"HAIL","AR",1215500,1475320,0,14,2690820,14
"2704",5,"HAIL","CA",26426000,685550,0,0,27111550,0
"2705",5,"HAIL","CO",1563000,202135050,0,4,203698050,4
"2706",5,"HAIL","CT",0,14000,0,0,14000,0
"2707",5,"HAIL","DC",0,500,0,0,500,0
"2708",5,"HAIL","FL",19250000,1268000,0,1,20518000,1
"2709",5,"HAIL","GA",10000,26761600,0,1,26771600,1
"2710",5,"HAIL","IA",5916850,117774450,4,92,123691300,96
"2711",5,"HAIL","ID",11000,69200,0,0,80200,0
"2712",5,"HAIL","IL",149000,57580500,0,42,57729500,42
"2713",5,"HAIL","IN",710000,76928100,0,0,77638100,0
"2714",5,"HAIL","KS",84538200,39092200,0,2,123630400,2
"2715",5,"HAIL","KY",4e+06,97470050,0,7,101470050,7
"2716",5,"HAIL","LA",5635000,1251900,0,1,6886900,1
"2717",5,"HAIL","MA",0,68000,0,2,68000,2
"2718",5,"HAIL","MD",0,880000,0,0,880000,0
"2719",5,"HAIL","MI",6785000,3027500,0,0,9812500,0
"2720",5,"HAIL","MN",1180500,604164300,0,2,605344800,2
"2721",5,"HAIL","MO",1197500,20228670,0,2,21426170,2
"2722",5,"HAIL","MS",3384000,3705050,0,0,7089050,0
"2723",5,"HAIL","MT",0,1260000,0,0,1260000,0
"2724",5,"HAIL","NC",12442000,24828500,0,1,37270500,1
"2725",5,"HAIL","ND",585000,10479600,0,2,11064600,2
"2726",5,"HAIL","NE",49105400,102525200,0,1,151630600,1
"2727",5,"HAIL","NH",0,8000,0,0,8000,0
"2728",5,"HAIL","NM",5080100,35692750,0,2,40772850,2
"2729",5,"HAIL","NV",0,5550,1,2,5550,3
"2730",5,"HAIL","NY",3020000,2756000,0,3,5776000,3
"2731",5,"HAIL","OH",250000,119207002,0,2,119457002,2
"2732",5,"HAIL","OK",355000,11069102,0,22,11424102,22
"2733",5,"HAIL","OR",1058000,31000,0,1,1089000,1
"2734",5,"HAIL","PA",5000,1529000,0,0,1534000,0
"2735",5,"HAIL","SC",27000,31020500,1,4,31047500,5
"2736",5,"HAIL","SD",220050,14769700,0,4,14989750,4
"2737",5,"HAIL","TN",0,3208840,0,13,3208840,13
"2738",5,"HAIL","TX",148135850,627815050,0,203,775950900,203
"2739",5,"HAIL","UT",500,0,0,0,500,0
"2740",5,"HAIL","VA",38000,20073580,0,2,20111580,2
"2741",5,"HAIL","VT",0,123000,0,0,123000,0
"2742",5,"HAIL","WA",50216000,85000,0,0,50301000,0
"2743",5,"HAIL","WI",4983100,148689750,0,36,153672850,36
"2744",5,"HAIL","WV",0,994000,0,0,994000,0
"2745",5,"HAIL","WY",183700,46276200,0,0,46459900,0
"2746",5,"HEAT","AL",0,0,0,24,0,24
"2747",5,"HEAT","AZ",0,0,12,0,0,12
"2748",5,"HEAT","CA",0,10000,4,23,10000,27
"2749",5,"HEAT","DC",0,0,0,2,0,2
"2750",5,"HEAT","IL",0,0,5,8,0,13
"2751",5,"HEAT","KY",0,0,1,1,0,2
"2752",5,"HEAT","LA",0,0,2,0,0,2
"2753",5,"HEAT","MD",0,0,0,2,0,2
"2754",5,"HEAT","MI",0,0,0,75,0,75
"2755",5,"HEAT","MO",0,0,2,27,0,29
"2756",5,"HEAT","NC",0,0,1,0,0,1
"2757",5,"HEAT","PA",0,0,9,4,0,13
"2758",5,"HEAT","TX",0,0,7,0,0,7
"2759",5,"HEAVY RAIN","AR",0,1500000,0,0,1500000,0
"2760",5,"HEAVY RAIN","CA",380821000,272000,1,1,381093000,2
"2761",5,"HEAVY RAIN","CO",0,0,1,1,0,2
"2762",5,"HEAVY RAIN","FL",0,8000,0,0,8000,0
"2763",5,"HEAVY RAIN","GA",0,18000,0,0,18000,0
"2764",5,"HEAVY RAIN","IA",11000,294000,0,0,305000,0
"2765",5,"HEAVY RAIN","ID",0,50045000,0,0,50045000,0
"2766",5,"HEAVY RAIN","IL",0,235000,0,0,235000,0
"2767",5,"HEAVY RAIN","KS",2e+05,911000,0,6,1111000,6
"2768",5,"HEAVY RAIN","KY",0,11000,0,0,11000,0
"2769",5,"HEAVY RAIN","LA",0,2.5e+09,0,0,2.5e+09,0
"2770",5,"HEAVY RAIN","MI",25000,10000,0,0,35000,0
"2771",5,"HEAVY RAIN","MO",0,247000,1,0,247000,1
"2772",5,"HEAVY RAIN","NC",0,20000,0,0,20000,0
"2773",5,"HEAVY RAIN","NE",345000,1645000,0,0,1990000,0
"2774",5,"HEAVY RAIN","NJ",0,0,0,2,0,2
"2775",5,"HEAVY RAIN","OH",0,26000,0,0,26000,0
"2776",5,"HEAVY RAIN","PA",0,0,2,2,0,4
"2777",5,"HEAVY RAIN","PR",0,249000,1,7,249000,8
"2778",5,"HEAVY RAIN","SD",70000,472000,0,0,542000,0
"2779",5,"HEAVY RAIN","TX",0,232000,2,23,232000,25
"2780",5,"HEAVY RAIN","UT",6000,120000,0,0,126000,0
"2781",5,"HEAVY RAIN","WA",0,23000,0,4,23000,4
"2782",5,"HEAVY RAIN","WI",0,0,0,2,0,2
"2783",5,"HEAVY RAIN","WV",0,49000,3,1,49000,4
"2784",5,"HEAVY SNOW","AK",0,185000,0,0,185000,0
"2785",5,"HEAVY SNOW","MI",0,3000,0,0,3000,0
"2786",5,"HEAVY SNOW","MT",0,2e+05,0,0,2e+05,0
"2787",5,"HEAVY SNOW","UT",700,25000,0,0,25700,0
"2788",5,"HEAVY SNOW","WA",0,45000,0,0,45000,0
"2789",5,"HIGH SURF","AK",0,15000,0,0,15000,0
"2790",5,"HIGH SURF","AS",0,3600000,0,0,3600000,0
"2791",5,"HIGH SURF","CA",0,275000,3,0,275000,3
"2792",5,"HIGH SURF","HI",0,0,1,4,0,5
"2793",5,"HIGH SURF","MA",0,0,1,2,0,3
"2794",5,"HIGH SURF","NY",0,0,3,0,0,3
"2795",5,"HIGH SURF","OR",0,0,3,0,0,3
"2796",5,"HIGH SURF","SC",0,0,1,0,0,1
"2797",5,"HIGH WIND","AK",0,50600,0,0,50600,0
"2798",5,"HIGH WIND","AL",0,61000,2,0,61000,2
"2799",5,"HIGH WIND","AR",0,45000,1,0,45000,1
"2800",5,"HIGH WIND","AZ",0,141000,0,1,141000,1
"2801",5,"HIGH WIND","CA",1960000,689000,1,1,2649000,2
"2802",5,"HIGH WIND","CO",50000,4303300,0,12,4353300,12
"2803",5,"HIGH WIND","CT",0,0,1,0,0,1
"2804",5,"HIGH WIND","DE",0,1e+05,0,0,1e+05,0
"2805",5,"HIGH WIND","IA",0,5553000,1,2,5553000,3
"2806",5,"HIGH WIND","ID",0,1266800,0,15,1266800,15
"2807",5,"HIGH WIND","IL",0,4483450,0,1,4483450,1
"2808",5,"HIGH WIND","KS",0,334620,1,1,334620,2
"2809",5,"HIGH WIND","KY",0,22000,0,0,22000,0
"2810",5,"HIGH WIND","LA",0,0,0,3,0,3
"2811",5,"HIGH WIND","MA",0,487000,0,1,487000,1
"2812",5,"HIGH WIND","MD",0,178000,0,2,178000,2
"2813",5,"HIGH WIND","ME",0,2e+05,0,0,2e+05,0
"2814",5,"HIGH WIND","MI",0,358000,0,0,358000,0
"2815",5,"HIGH WIND","MN",0,27000,0,0,27000,0
"2816",5,"HIGH WIND","MO",0,30000,0,0,30000,0
"2817",5,"HIGH WIND","MS",0,5000,0,0,5000,0
"2818",5,"HIGH WIND","MT",108000,336500,0,4,444500,4
"2819",5,"HIGH WIND","NC",0,39000,0,0,39000,0
"2820",5,"HIGH WIND","ND",0,210000,0,1,210000,1
"2821",5,"HIGH WIND","NE",0,475000,0,10,475000,10
"2822",5,"HIGH WIND","NJ",0,125000,0,0,125000,0
"2823",5,"HIGH WIND","NM",0,57800,7,0,57800,7
"2824",5,"HIGH WIND","NV",0,443500,0,0,443500,0
"2825",5,"HIGH WIND","NY",0,1527000,1,22,1527000,23
"2826",5,"HIGH WIND","OH",50000,1518000,1,0,1568000,1
"2827",5,"HIGH WIND","OK",0,109100,0,3,109100,3
"2828",5,"HIGH WIND","OR",0,177000,1,0,177000,1
"2829",5,"HIGH WIND","PA",0,612000,1,2,612000,3
"2830",5,"HIGH WIND","RI",0,45000,0,0,45000,0
"2831",5,"HIGH WIND","SC",0,3000,0,6,3000,6
"2832",5,"HIGH WIND","SD",0,1180000,0,0,1180000,0
"2833",5,"HIGH WIND","TX",50,1264000,0,9,1264050,9
"2834",5,"HIGH WIND","UT",408800,3150400,0,1,3559200,1
"2835",5,"HIGH WIND","VA",0,163300,2,6,163300,8
"2836",5,"HIGH WIND","VT",0,32400,0,0,32400,0
"2837",5,"HIGH WIND","WA",0,625000,0,1,625000,1
"2838",5,"HIGH WIND","WI",0,151000,0,0,151000,0
"2839",5,"HIGH WIND","WV",0,14900,0,0,14900,0
"2840",5,"HIGH WIND","WY",16000,126000,0,0,142000,0
"2841",5,"ICE STORM","ND",0,2e+06,0,0,2e+06,0
"2842",5,"LAKESHORE FLOOD","KY",0,30000,0,0,30000,0
"2843",5,"LAKESHORE FLOOD","NY",0,4500000,0,0,4500000,0
"2844",5,"LAKESHORE FLOOD","VT",0,3e+06,0,0,3e+06,0
"2845",5,"LIGHTNING","AK",0,0,0,2,0,2
"2846",5,"LIGHTNING","AL",0,3399500,3,19,3399500,22
"2847",5,"LIGHTNING","AR",0,3753000,1,9,3753000,10
"2848",5,"LIGHTNING","AZ",0,2e+05,4,0,2e+05,4
"2849",5,"LIGHTNING","CA",3e+05,1525000,1,1,1825000,2
"2850",5,"LIGHTNING","CO",0,2266071,5,26,2266071,31
"2851",5,"LIGHTNING","CT",0,64000,2,8,64000,10
"2852",5,"LIGHTNING","DE",0,277000,1,0,277000,1
"2853",5,"LIGHTNING","FL",15000,3550000,3,48,3565000,51
"2854",5,"LIGHTNING","GA",3001000,7449500,5,21,10450500,26
"2855",5,"LIGHTNING","GU",0,50000,0,0,50000,0
"2856",5,"LIGHTNING","HI",0,50000,0,0,50000,0
"2857",5,"LIGHTNING","IA",0,1881500,1,9,1881500,10
"2858",5,"LIGHTNING","ID",0,105000,0,0,105000,0
"2859",5,"LIGHTNING","IL",0,3559000,2,10,3559000,12
"2860",5,"LIGHTNING","IN",0,5882500,3,17,5882500,20
"2861",5,"LIGHTNING","KS",20000,2006500,1,6,2026500,7
"2862",5,"LIGHTNING","KY",0,978000,2,5,978000,7
"2863",5,"LIGHTNING","LA",0,738000,3,14,738000,17
"2864",5,"LIGHTNING","MA",0,2677130,0,9,2677130,9
"2865",5,"LIGHTNING","MD",0,8060000,1,2,8060000,3
"2866",5,"LIGHTNING","ME",0,134300,0,2,134300,2
"2867",5,"LIGHTNING","MI",0,917800,0,17,917800,17
"2868",5,"LIGHTNING","MN",15000,1445500,1,1,1460500,2
"2869",5,"LIGHTNING","MO",0,1157000,2,8,1157000,10
"2870",5,"LIGHTNING","MS",0,741000,3,6,741000,9
"2871",5,"LIGHTNING","MT",0,8e+05,1,5,8e+05,6
"2872",5,"LIGHTNING","NC",2020000,5321000,2,10,7341000,12
"2873",5,"LIGHTNING","ND",0,55000,0,1,55000,1
"2874",5,"LIGHTNING","NE",0,847900,0,4,847900,4
"2875",5,"LIGHTNING","NH",0,1570000,0,2,1570000,2
"2876",5,"LIGHTNING","NJ",1000,314000,2,18,315000,20
"2877",5,"LIGHTNING","NM",0,25000,2,1,25000,3
"2878",5,"LIGHTNING","NV",0,0,1,4,0,5
"2879",5,"LIGHTNING","NY",0,1016500,0,20,1016500,20
"2880",5,"LIGHTNING","OH",0,2200000,4,13,2200000,17
"2881",5,"LIGHTNING","OK",1000,3281400,1,7,3282400,8
"2882",5,"LIGHTNING","OR",0,170500,1,1,170500,2
"2883",5,"LIGHTNING","PA",0,2109200,1,17,2109200,18
"2884",5,"LIGHTNING","PR",0,0,1,1,0,2
"2885",5,"LIGHTNING","RI",0,125000,0,0,125000,0
"2886",5,"LIGHTNING","SC",0,6378000,1,6,6378000,7
"2887",5,"LIGHTNING","SD",0,414000,0,0,414000,0
"2888",5,"LIGHTNING","TN",0,7023020,3,9,7023020,12
"2889",5,"LIGHTNING","TX",0,6866300,7,35,6866300,42
"2890",5,"LIGHTNING","UT",0,122100,2,14,122100,16
"2891",5,"LIGHTNING","VA",30000,1720013,1,10,1750013,11
"2892",5,"LIGHTNING","VI",0,60000,0,0,60000,0
"2893",5,"LIGHTNING","VT",0,375000,0,1,375000,1
"2894",5,"LIGHTNING","WA",0,354000,0,2,354000,2
"2895",5,"LIGHTNING","WI",50000,3168100,0,10,3218100,10
"2896",5,"LIGHTNING","WV",0,651003,0,3,651003,3
"2897",5,"LIGHTNING","WY",42000,215000,0,0,257000,0
"2898",5,"MARINE HIGH WIND","AN",0,10000,1,1,10000,2
"2899",5,"MARINE HIGH WIND","GM",0,51000,0,0,51000,0
"2900",5,"MARINE HIGH WIND","LM",0,1e+05,0,0,1e+05,0
"2901",5,"MARINE STRONG WIND","AN",0,0,0,3,0,3
"2902",5,"MARINE STRONG WIND","GM",0,2000,0,0,2000,0
"2903",5,"MARINE STRONG WIND","LM",0,0,1,0,0,1
"2904",5,"MARINE THUNDERSTORM WIND","AM",0,50000,0,0,50000,0
"2905",5,"MARINE THUNDERSTORM WIND","AN",0,10000,0,0,10000,0
"2906",5,"MARINE THUNDERSTORM WIND","GM",0,102000,0,0,102000,0
"2907",5,"MARINE THUNDERSTORM WIND","LM",0,225000,0,0,225000,0
"2908",5,"MARINE THUNDERSTORM WIND","LO",0,10000,0,0,10000,0
"2909",5,"OTHER EVENT NON IDENTIFIED","OH",1034400,0,0,0,1034400,0
"2910",5,"RIP CURRENT","AL",0,0,6,0,0,6
"2911",5,"RIP CURRENT","CA",0,0,5,2,0,7
"2912",5,"RIP CURRENT","FL",0,0,40,44,0,84
"2913",5,"RIP CURRENT","GU",0,0,1,0,0,1
"2914",5,"RIP CURRENT","LA",0,0,1,0,0,1
"2915",5,"RIP CURRENT","MI",0,0,1,0,0,1
"2916",5,"RIP CURRENT","NC",0,0,5,0,0,5
"2917",5,"RIP CURRENT","NJ",0,0,1,0,0,1
"2918",5,"RIP CURRENT","NY",0,0,2,0,0,2
"2919",5,"RIP CURRENT","SC",0,0,2,1,0,3
"2920",5,"RIP CURRENT","TX",0,0,3,5,0,8
"2921",5,"RIP CURRENT","VA",0,0,1,0,0,1
"2922",5,"SEICHE","MI",0,20000,0,0,20000,0
"2923",5,"STORM SURGE/TIDE","MA",0,125000,0,0,125000,0
"2924",5,"STORM SURGE/TIDE","ME",0,1165000,0,0,1165000,0
"2925",5,"STORM SURGE/TIDE","NH",0,150000,0,0,150000,0
"2926",5,"STORM SURGE/TIDE","PA",0,20000,0,0,20000,0
"2927",5,"STRONG WIND","AL",0,30000,1,1,30000,2
"2928",5,"STRONG WIND","AZ",0,11207000,4,1,11207000,5
"2929",5,"STRONG WIND","CA",0,186000,0,0,186000,0
"2930",5,"STRONG WIND","CO",0,54250,0,0,54250,0
"2931",5,"STRONG WIND","CT",0,160000,0,0,160000,0
"2932",5,"STRONG WIND","DC",0,1000,0,0,1000,0
"2933",5,"STRONG WIND","DE",0,20500,0,0,20500,0
"2934",5,"STRONG WIND","FL",0,100,0,0,100,0
"2935",5,"STRONG WIND","GA",0,110000,1,0,110000,1
"2936",5,"STRONG WIND","IA",0,6550,0,0,6550,0
"2937",5,"STRONG WIND","ID",0,3000,0,0,3000,0
"2938",5,"STRONG WIND","IL",4000,317500,0,0,321500,0
"2939",5,"STRONG WIND","IN",0,116000,0,0,116000,0
"2940",5,"STRONG WIND","KS",0,282000,0,0,282000,0
"2941",5,"STRONG WIND","KY",0,28000,0,0,28000,0
"2942",5,"STRONG WIND","MA",2000,5000,0,0,7000,0
"2943",5,"STRONG WIND","MD",0,51340,0,0,51340,0
"2944",5,"STRONG WIND","ME",0,10000,0,0,10000,0
"2945",5,"STRONG WIND","MI",0,43500,0,0,43500,0
"2946",5,"STRONG WIND","MN",0,13150,1,10,13150,11
"2947",5,"STRONG WIND","MO",9000,23000,0,0,32000,0
"2948",5,"STRONG WIND","MS",0,99100,0,0,99100,0
"2949",5,"STRONG WIND","NC",0,12000,0,0,12000,0
"2950",5,"STRONG WIND","ND",5e+06,0,0,0,5e+06,0
"2951",5,"STRONG WIND","NE",0,10000,1,1,10000,2
"2952",5,"STRONG WIND","NJ",0,66000,0,0,66000,0
"2953",5,"STRONG WIND","NM",0,25000,0,0,25000,0
"2954",5,"STRONG WIND","NV",0,146700,1,0,146700,1
"2955",5,"STRONG WIND","NY",0,239000,0,1,239000,1
"2956",5,"STRONG WIND","OH",0,1230000,0,0,1230000,0
"2957",5,"STRONG WIND","PA",0,249000,0,2,249000,2
"2958",5,"STRONG WIND","PR",0,100,0,0,100,0
"2959",5,"STRONG WIND","SC",0,50000,0,0,50000,0
"2960",5,"STRONG WIND","SD",0,250000,0,2,250000,2
"2961",5,"STRONG WIND","TN",0,70000,0,0,70000,0
"2962",5,"STRONG WIND","TX",0,80500,0,0,80500,0
"2963",5,"STRONG WIND","UT",0,500,0,0,500,0
"2964",5,"STRONG WIND","VA",0,26000,0,0,26000,0
"2965",5,"STRONG WIND","VT",0,67000,0,0,67000,0
"2966",5,"STRONG WIND","WA",0,56000,0,0,56000,0
"2967",5,"STRONG WIND","WI",0,110500,0,1,110500,1
"2968",5,"STRONG WIND","WV",0,55000,0,0,55000,0
"2969",5,"THUNDERSTORM WIND","AK",0,5000,0,0,5000,0
"2970",5,"THUNDERSTORM WIND","AL",106000,11608400,2,33,11714400,35
"2971",5,"THUNDERSTORM WIND","AR",0,20719150,6,31,20719150,37
"2972",5,"THUNDERSTORM WIND","AZ",5000,304500,0,1,309500,1
"2973",5,"THUNDERSTORM WIND","CA",17400000,2905000,2,16,20305000,18
"2974",5,"THUNDERSTORM WIND","CO",0,5117500,0,25,5117500,25
"2975",5,"THUNDERSTORM WIND","CT",0,1173600,0,0,1173600,0
"2976",5,"THUNDERSTORM WIND","DC",0,97000,1,12,97000,13
"2977",5,"THUNDERSTORM WIND","FL",500,14586915,3,11,14587415,14
"2978",5,"THUNDERSTORM WIND","GA",355000,41510100,6,51,41865100,57
"2979",5,"THUNDERSTORM WIND","IA",697000,25135570,1,17,25832570,18
"2980",5,"THUNDERSTORM WIND","ID",1000,1454000,0,6,1455000,6
"2981",5,"THUNDERSTORM WIND","IL",93000,302670691,10,55,302763691,65
"2982",5,"THUNDERSTORM WIND","IN",7000,22229308,4,46,22236308,50
"2983",5,"THUNDERSTORM WIND","KS",12465100,70927005,3,55,83392105,58
"2984",5,"THUNDERSTORM WIND","KY",5000,192515503,3,149,192520503,152
"2985",5,"THUNDERSTORM WIND","LA",543000,725763050,6,56,726306050,62
"2986",5,"THUNDERSTORM WIND","MA",0,16262000,3,69,16262000,72
"2987",5,"THUNDERSTORM WIND","MD",0,2652950,0,28,2652950,28
"2988",5,"THUNDERSTORM WIND","ME",0,0,0,1,0,1
"2989",5,"THUNDERSTORM WIND","MI",35350000,185261200,11,178,220611200,189
"2990",5,"THUNDERSTORM WIND","MN",238000,474640550,0,33,474878550,33
"2991",5,"THUNDERSTORM WIND","MO",249500,163603880,3,21,163853380,24
"2992",5,"THUNDERSTORM WIND","MS",2709300,23541300,2,27,26250600,29
"2993",5,"THUNDERSTORM WIND","MT",0,5177000,0,2,5177000,2
"2994",5,"THUNDERSTORM WIND","NC",322000,17365503,5,36,17687503,41
"2995",5,"THUNDERSTORM WIND","ND",425000,13587100,0,8,14012100,8
"2996",5,"THUNDERSTORM WIND","NE",8413000,25769000,0,13,34182000,13
"2997",5,"THUNDERSTORM WIND","NH",0,171000,0,3,171000,3
"2998",5,"THUNDERSTORM WIND","NJ",0,2302500,0,20,2302500,20
"2999",5,"THUNDERSTORM WIND","NM",10000,3675000,0,2,3685000,2
"3000",5,"THUNDERSTORM WIND","NV",0,25500,0,0,25500,0
"3001",5,"THUNDERSTORM WIND","NY",165000,13529400,5,34,13694400,39
"3002",5,"THUNDERSTORM WIND","OH",0,30644015,4,46,30644015,50
"3003",5,"THUNDERSTORM WIND","OK",125000,63180210,2,44,63305210,46
"3004",5,"THUNDERSTORM WIND","OR",50000,1093000,0,1,1143000,1
"3005",5,"THUNDERSTORM WIND","PA",0,18505200,6,106,18505200,112
"3006",5,"THUNDERSTORM WIND","PR",0,372000,0,0,372000,0
"3007",5,"THUNDERSTORM WIND","RI",0,15000,0,0,15000,0
"3008",5,"THUNDERSTORM WIND","SC",0,4119650,2,46,4119650,48
"3009",5,"THUNDERSTORM WIND","SD",50500,8153000,1,20,8203500,21
"3010",5,"THUNDERSTORM WIND","TN",1512000,27443770,2,66,28955770,68
"3011",5,"THUNDERSTORM WIND","TX",9461600,1516561190,16,175,1526022790,191
"3012",5,"THUNDERSTORM WIND","UT",5000,52464100,0,15,52469100,15
"3013",5,"THUNDERSTORM WIND","VA",177000,14237836,5,41,14414836,46
"3014",5,"THUNDERSTORM WIND","VT",0,1395000,0,4,1395000,4
"3015",5,"THUNDERSTORM WIND","WA",1200000,1421500,0,0,2621500,0
"3016",5,"THUNDERSTORM WIND","WI",2675650,80222950,3,48,82898600,51
"3017",5,"THUNDERSTORM WIND","WV",0,3613500,2,9,3613500,11
"3018",5,"THUNDERSTORM WIND","WY",0,606200,0,0,606200,0
"3019",5,"TORNADO","AL",73000,250944250,27,503,251017250,530
"3020",5,"TORNADO","AR",2e+05,203536240,69,971,203736240,1040
"3021",5,"TORNADO","AZ",0,25280,0,0,25280,0
"3022",5,"TORNADO","CA",405000,10515060,0,4,10920060,4
"3023",5,"TORNADO","CO",2500,166431200,1,109,166433700,110
"3024",5,"TORNADO","CT",0,5096500,1,52,5096500,53
"3025",5,"TORNADO","DE",0,5e+05,0,10,5e+05,10
"3026",5,"TORNADO","FL",0,93643020,9,213,93643020,222
"3027",5,"TORNADO","GA",5000,216825060,10,251,216830060,261
"3028",5,"TORNADO","IA",762300,743340620,34,987,744102920,1021
"3029",5,"TORNADO","ID",0,962030,0,0,962030,0
"3030",5,"TORNADO","IL",0,421038862,25,606,421038862,631
"3031",5,"TORNADO","IN",0,119675090,7,140,119675090,147
"3032",5,"TORNADO","KS",10945000,718758120,130,900,729703120,1030
"3033",5,"TORNADO","KY",1e+05,299369500,4,197,299469500,201
"3034",5,"TORNADO","LA",1100000,211541900,4,165,212641900,169
"3035",5,"TORNADO","MA",0,93275,3,24,93275,27
"3036",5,"TORNADO","MD",0,18647000,2,25,18647000,27
"3037",5,"TORNADO","ME",0,280250,0,0,280250,0
"3038",5,"TORNADO","MI",451000,103877590,23,570,104328590,593
"3039",5,"TORNADO","MN",60000,689181060,25,853,689241060,878
"3040",5,"TORNADO","MO",20009500,3476293500,259,2195,3496303000,2454
"3041",5,"TORNADO","MS",1850000,134633030,5,161,136483030,166
"3042",5,"TORNADO","MT",0,1490560,0,0,1490560,0
"3043",5,"TORNADO","NC",1475000,251287500,9,216,252762500,225
"3044",5,"TORNADO","ND",50000,8245280,2,36,8295280,38
"3045",5,"TORNADO","NE",5742000,725646110,26,472,731388110,498
"3046",5,"TORNADO","NH",0,835750,0,2,835750,2
"3047",5,"TORNADO","NJ",0,7277500,0,13,7277500,13
"3048",5,"TORNADO","NM",0,29807050,2,35,29807050,37
"3049",5,"TORNADO","NV",0,30000,0,1,30000,1
"3050",5,"TORNADO","NY",215000,137152500,3,140,137367500,143
"3051",5,"TORNADO","OH",11000,928686250,21,642,928697250,663
"3052",5,"TORNADO","OK",556500,2047637480,163,2491,2048193980,2654
"3053",5,"TORNADO","OR",0,235000,0,0,235000,0
"3054",5,"TORNADO","PA",0,408769000,66,587,408769000,653
"3055",5,"TORNADO","SC",10050,38972180,13,182,38982230,195
"3056",5,"TORNADO","SD",620000,47402870,6,231,48022870,237
"3057",5,"TORNADO","TN",223000,150256570,28,471,150479570,499
"3058",5,"TORNADO","TX",2011000,832262870.2,269,2367,834273870.2,2636
"3059",5,"TORNADO","UT",3700,1402650,0,1,1406350,1
"3060",5,"TORNADO","VA",0,53421750,3,31,53421750,34
"3061",5,"TORNADO","VT",0,905000,0,2,905000,2
"3062",5,"TORNADO","WA",0,943310,0,0,943310,0
"3063",5,"TORNADO","WI",240000,110423530,4,137,110663530,141
"3064",5,"TORNADO","WV",0,1012500,0,5,1012500,5
"3065",5,"TORNADO","WY",0,4408150,0,9,4408150,9
"3066",5,"TROPICAL STORM","GU",1000,1.8e+07,0,0,18001000,0
"3067",5,"WATERSPOUT","AN",0,0,0,1,0,1
"3068",5,"WATERSPOUT","MS",0,5e+05,0,0,5e+05,0
"3069",5,"WATERSPOUT","NC",0,65000,0,0,65000,0
"3070",5,"WATERSPOUT","TX",0,75000,0,0,75000,0
"3071",5,"WILDFIRE","AK",0,1900000,0,9,1900000,9
"3072",5,"WILDFIRE","AZ",0,3800000,0,1,3800000,1
"3073",5,"WILDFIRE","CA",5e+05,29190000,0,56,29690000,56
"3074",5,"WILDFIRE","CO",0,2324000,0,3,2324000,3
"3075",5,"WILDFIRE","FL",0,17240000,0,4,17240000,4
"3076",5,"WILDFIRE","GA",0,21700000,0,0,21700000,0
"3077",5,"WILDFIRE","GU",0,0,0,1,0,1
"3078",5,"WILDFIRE","HI",0,50000,0,0,50000,0
"3079",5,"WILDFIRE","IL",0,2050000,0,0,2050000,0
"3080",5,"WILDFIRE","MI",1e+06,6260000,0,4,7260000,4
"3081",5,"WILDFIRE","MN",0,4e+06,0,0,4e+06,0
"3082",5,"WILDFIRE","MT",0,55000,0,0,55000,0
"3083",5,"WILDFIRE","NJ",0,5e+05,0,2,5e+05,2
"3084",5,"WILDFIRE","NM",0,1505665000,0,13,1505665000,13
"3085",5,"WILDFIRE","NY",0,0,0,2,0,2
"3086",5,"WILDFIRE","OR",0,10000,0,0,10000,0
"3087",5,"WILDFIRE","PR",0,50000,0,0,50000,0
"3088",5,"WILDFIRE","TX",1e+05,4300000,0,10,4400000,10
"3089",5,"WILDFIRE","WI",0,1e+06,0,0,1e+06,0
"3090",5,"WINTER STORM","CO",0,150000,0,0,150000,0
"3091",5,"WINTER STORM","MT",0,3e+06,0,0,3e+06,0
"3092",5,"WINTER STORM","SD",0,5e+05,0,0,5e+05,0
"3093",5,"WINTER STORM","WA",0,0,2,0,0,2
"3094",5,"WINTER WEATHER","CA",0,5000,0,0,5000,0
"3095",5,"WINTER WEATHER","VT",0,4000,0,0,4000,0
"3096",5,"WINTER WEATHER","WA",0,11000,0,0,11000,0
"3097",5,"WINTER WEATHER","WI",1.5e+07,0,0,0,1.5e+07,0
"3098",6,"ASTRONOMICAL LOW TIDE","ME",0,2e+05,0,0,2e+05,0
"3099",6,"AVALANCHE","WA",0,0,1,7,0,8
"3100",6,"COASTAL FLOOD","AL",0,3000,0,0,3000,0
"3101",6,"COASTAL FLOOD","GA",0,25000,0,0,25000,0
"3102",6,"COASTAL FLOOD","LA",0,2000,0,0,2000,0
"3103",6,"COASTAL FLOOD","MA",0,3000,0,0,3000,0
"3104",6,"COASTAL FLOOD","MD",0,20000,0,0,20000,0
"3105",6,"COASTAL FLOOD","ME",0,22500,0,0,22500,0
"3106",6,"COASTAL FLOOD","SC",0,75000,0,0,75000,0
"3107",6,"COLD/WIND CHILL","CO",254000,0,0,0,254000,0
"3108",6,"COLD/WIND CHILL","ND",75000,0,0,0,75000,0
"3109",6,"COLD/WIND CHILL","NE",40000,0,0,0,40000,0
"3110",6,"COLD/WIND CHILL","WY",150000,0,0,0,150000,0
"3111",6,"DEBRIS FLOW","AR",0,25000,0,0,25000,0
"3112",6,"DEBRIS FLOW","CA",0,2.7e+07,0,5,2.7e+07,5
"3113",6,"DEBRIS FLOW","CO",0,0,1,0,0,1
"3114",6,"DEBRIS FLOW","NV",0,21000,0,0,21000,0
"3115",6,"DEBRIS FLOW","PR",0,1000,0,0,1000,0
"3116",6,"DEBRIS FLOW","WA",0,10000,0,2,10000,2
"3117",6,"DEBRIS FLOW","WY",0,215000,0,0,215000,0
"3118",6,"DENSE FOG","CA",0,105000,0,25,105000,25
"3119",6,"DENSE FOG","CO",0,0,1,0,0,1
"3120",6,"DENSE FOG","IL",0,1e+05,0,0,1e+05,0
"3121",6,"DENSE FOG","MD",0,0,0,8,0,8
"3122",6,"DROUGHT","GA",306720000,0,0,0,306720000,0
"3123",6,"DROUGHT","LA",15100000,0,0,0,15100000,0
"3124",6,"DROUGHT","MS",4e+05,0,0,0,4e+05,0
"3125",6,"DROUGHT","NC",67000,0,0,0,67000,0
"3126",6,"DROUGHT","OK",1.51e+08,1e+05,0,0,151100000,0
"3127",6,"DROUGHT","TX",426662000,23404000,0,0,450066000,0
"3128",6,"DUST DEVIL","AL",0,5000,0,0,5000,0
"3129",6,"DUST DEVIL","AZ",0,40000,0,0,40000,0
"3130",6,"DUST DEVIL","CA",0,500,0,0,500,0
"3131",6,"DUST DEVIL","CO",0,10000,0,0,10000,0
"3132",6,"DUST DEVIL","FL",0,3000,0,0,3000,0
"3133",6,"DUST DEVIL","NM",0,15000,0,0,15000,0
"3134",6,"DUST DEVIL","NV",0,75000,0,0,75000,0
"3135",6,"DUST DEVIL","PA",0,0,0,1,0,1
"3136",6,"DUST DEVIL","WA",0,6000,0,0,6000,0
"3137",6,"DUST DEVIL","WY",0,1000,1,0,1000,1
"3138",6,"DUST STORM","NM",0,15000,0,0,15000,0
"3139",6,"DUST STORM","TX",2250000,640000,0,0,2890000,0
"3140",6,"FLASH FLOOD","AL",0,5903000,1,4,5903000,5
"3141",6,"FLASH FLOOD","AR",0,15017000,20,25,15017000,45
"3142",6,"FLASH FLOOD","AS",0,5000,0,0,5000,0
"3143",6,"FLASH FLOOD","AZ",0,75000,0,0,75000,0
"3144",6,"FLASH FLOOD","CA",0,18000,0,0,18000,0
"3145",6,"FLASH FLOOD","CO",916000,24724000,2,3,25640000,5
"3146",6,"FLASH FLOOD","CT",0,95000,0,0,95000,0
"3147",6,"FLASH FLOOD","DC",0,10040000,0,0,10040000,0
"3148",6,"FLASH FLOOD","DE",0,1300000,0,0,1300000,0
"3149",6,"FLASH FLOOD","FL",0,8786000,0,1,8786000,1
"3150",6,"FLASH FLOOD","GA",0,12601250,0,0,12601250,0
"3151",6,"FLASH FLOOD","GU",5e+05,5500000,1,0,6e+06,1
"3152",6,"FLASH FLOOD","IA",15660000,74255000,2,7,89915000,9
"3153",6,"FLASH FLOOD","ID",0,1668000,1,0,1668000,1
"3154",6,"FLASH FLOOD","IL",10769000,164830500,0,1,175599500,1
"3155",6,"FLASH FLOOD","IN",92088000,204552400,5,1,296640400,6
"3156",6,"FLASH FLOOD","KS",6998000,18617900,1,3,25615900,4
"3157",6,"FLASH FLOOD","KY",5825000,20005000,4,4,25830000,8
"3158",6,"FLASH FLOOD","LA",0,8669000,0,1,8669000,1
"3159",6,"FLASH FLOOD","MA",0,2302000,0,0,2302000,0
"3160",6,"FLASH FLOOD","MD",1070000,19902000,8,3,20972000,11
"3161",6,"FLASH FLOOD","ME",0,2851000,0,0,2851000,0
"3162",6,"FLASH FLOOD","MI",10670000,77072000,5,6,87742000,11
"3163",6,"FLASH FLOOD","MN",3272000,48585600,4,3,51857600,7
"3164",6,"FLASH FLOOD","MO",15000,6568510,3,5,6583510,8
"3165",6,"FLASH FLOOD","MS",0,30275000,0,0,30275000,0
"3166",6,"FLASH FLOOD","MT",325000,4735000,0,0,5060000,0
"3167",6,"FLASH FLOOD","NC",630000,8061250,7,1,8691250,8
"3168",6,"FLASH FLOOD","ND",12792000,145887000,2,0,158679000,2
"3169",6,"FLASH FLOOD","NE",14450000,10950000,0,0,25400000,0
"3170",6,"FLASH FLOOD","NH",0,2025000,0,1,2025000,1
"3171",6,"FLASH FLOOD","NJ",0,8e+06,1,0,8e+06,1
"3172",6,"FLASH FLOOD","NM",0,5962000,0,14,5962000,14
"3173",6,"FLASH FLOOD","NV",5000,1010000,0,0,1015000,0
"3174",6,"FLASH FLOOD","NY",140000,883060500,13,1,883200500,14
"3175",6,"FLASH FLOOD","OH",20652000,169424025,9,0,190076025,9
"3176",6,"FLASH FLOOD","OK",40000,15911700,4,142,15951700,146
"3177",6,"FLASH FLOOD","OR",0,86000,0,0,86000,0
"3178",6,"FLASH FLOOD","PA",0,447538009,9,0,447538009,9
"3179",6,"FLASH FLOOD","PR",0,414000,0,0,414000,0
"3180",6,"FLASH FLOOD","SC",0,5887000,1,2,5887000,3
"3181",6,"FLASH FLOOD","SD",760000,24123700,2,0,24883700,2
"3182",6,"FLASH FLOOD","TN",11000,2074050,1,0,2085050,1
"3183",6,"FLASH FLOOD","TX",18163000,286955000,20,14,305118000,34
"3184",6,"FLASH FLOOD","UT",5000,180000,0,0,185000,0
"3185",6,"FLASH FLOOD","VA",41473500,39280553.4,7,9,80754053.4,16
"3186",6,"FLASH FLOOD","VT",7e+05,16700000,0,0,17400000,0
"3187",6,"FLASH FLOOD","WA",10000,1132000,0,0,1142000,0
"3188",6,"FLASH FLOOD","WI",312855000,522240060,1,5,835095060,6
"3189",6,"FLASH FLOOD","WV",695000,77257200,6,1,77952200,7
"3190",6,"FLASH FLOOD","WY",0,178000,0,0,178000,0
"3191",6,"FLOOD","AK",0,211000,0,0,211000,0
"3192",6,"FLOOD","AL",0,20000,0,0,20000,0
"3193",6,"FLOOD","AR",775000,81000,0,0,856000,0
"3194",6,"FLOOD","AS",0,57000,0,0,57000,0
"3195",6,"FLOOD","CA",1e+08,680500,0,0,100680500,0
"3196",6,"FLOOD","CO",104000,3459650,0,0,3563650,0
"3197",6,"FLOOD","CT",0,117000,0,0,117000,0
"3198",6,"FLOOD","FL",0,43024500,1,1,43024500,2
"3199",6,"FLOOD","GA",0,8849000,0,0,8849000,0
"3200",6,"FLOOD","IA",1487389300,1089076000,3,0,2576465300,3
"3201",6,"FLOOD","ID",0,57236000,0,0,57236000,0
"3202",6,"FLOOD","IL",18969000,17410200,2,0,36379200,2
"3203",6,"FLOOD","IN",591433000,506929000,2,0,1098362000,2
"3204",6,"FLOOD","KS",12912000,11584350,0,0,24496350,0
"3205",6,"FLOOD","KY",350000,18839000,1,0,19189000,1
"3206",6,"FLOOD","LA",3e+05,25271000,0,0,25571000,0
"3207",6,"FLOOD","MA",0,13245000,0,0,13245000,0
"3208",6,"FLOOD","MD",0,36000,0,0,36000,0
"3209",6,"FLOOD","ME",0,1754000,0,0,1754000,0
"3210",6,"FLOOD","MI",5000,1935000,1,0,1940000,1
"3211",6,"FLOOD","MN",78907800,225573600,0,2,304481400,2
"3212",6,"FLOOD","MO",50917000,14800000,2,0,65717000,2
"3213",6,"FLOOD","MS",6e+05,859100,0,0,1459100,0
"3214",6,"FLOOD","MT",0,1321000,3,0,1321000,3
"3215",6,"FLOOD","NC",15005000,731000,1,0,15736000,1
"3216",6,"FLOOD","ND",57290000,82542000,0,0,139832000,0
"3217",6,"FLOOD","NE",9865000,25603900,1,0,35468900,1
"3218",6,"FLOOD","NH",0,3825000,1,1,3825000,2
"3219",6,"FLOOD","NJ",0,31600000,1,0,31600000,1
"3220",6,"FLOOD","NM",0,180000,0,0,180000,0
"3221",6,"FLOOD","NV",0,266000,0,0,266000,0
"3222",6,"FLOOD","NY",1e+06,172573000,2,22,173573000,24
"3223",6,"FLOOD","OH",84550000,127049000,4,5,211599000,9
"3224",6,"FLOOD","OK",10000,408000,0,0,418000,0
"3225",6,"FLOOD","OR",10000,10000,0,0,20000,0
"3226",6,"FLOOD","PA",3e+06,194751000,4,1,197751000,5
"3227",6,"FLOOD","PR",0,92000,0,0,92000,0
"3228",6,"FLOOD","RI",0,35000,0,0,35000,0
"3229",6,"FLOOD","SC",0,230000,0,0,230000,0
"3230",6,"FLOOD","SD",2606000,7437000,0,0,10043000,0
"3231",6,"FLOOD","TN",297000,730500,0,0,1027500,0
"3232",6,"FLOOD","TX",8250000,81121000,6,222,89371000,228
"3233",6,"FLOOD","UT",0,7720000,0,0,7720000,0
"3234",6,"FLOOD","VA",240000,1424500,1,1,1664500,2
"3235",6,"FLOOD","VT",0,180000,0,0,180000,0
"3236",6,"FLOOD","WA",0,1671000,0,0,1671000,0
"3237",6,"FLOOD","WI",457327500,85614000,0,0,542941500,0
"3238",6,"FLOOD","WV",0,3839000,0,0,3839000,0
"3239",6,"FLOOD","WY",415000,14052000,1,0,14467000,1
"3240",6,"FROST/FREEZE","ID",1e+05,0,0,0,1e+05,0
"3241",6,"FUNNEL CLOUD","CA",0,5000,0,2,5000,2
"3242",6,"HAIL","AK",0,2015000,0,0,2015000,0
"3243",6,"HAIL","AL",77000,496000,0,0,573000,0
"3244",6,"HAIL","AR",8055000,65882450,0,0,73937450,0
"3245",6,"HAIL","AZ",0,0,0,1,0,1
"3246",6,"HAIL","CA",34320000,100,0,0,34320100,0
"3247",6,"HAIL","CO",60845000,449922380,0,29,510767380,29
"3248",6,"HAIL","CT",30000,262030.7,0,0,292030.7,0
"3249",6,"HAIL","DE",3e+05,0,0,0,3e+05,0
"3250",6,"HAIL","FL",1e+05,447500,0,2,547500,2
"3251",6,"HAIL","GA",275000,31689150,0,5,31964150,5
"3252",6,"HAIL","IA",18637500,22613700,0,5,41251200,5
"3253",6,"HAIL","ID",251000,1027300,0,5,1278300,5
"3254",6,"HAIL","IL",592500,18262800,0,0,18855300,0
"3255",6,"HAIL","IN",2415000,2159550,0,0,4574550,0
"3256",6,"HAIL","KS",105027600,42942750,0,65,147970350,65
"3257",6,"HAIL","KY",83150,712450,0,0,795600,0
"3258",6,"HAIL","LA",0,152000,0,0,152000,0
"3259",6,"HAIL","MA",50000,23000,0,0,73000,0
"3260",6,"HAIL","MD",55000,198000,0,1,253000,1
"3261",6,"HAIL","MI",1099000,70006800,0,3,71105800,3
"3262",6,"HAIL","MN",46027800,70219500,0,20,116247300,20
"3263",6,"HAIL","MO",7339000,8736110,0,2,16075110,2
"3264",6,"HAIL","MS",275000,2608550,0,15,2883550,15
"3265",6,"HAIL","MT",30131000,74299200,0,0,104430200,0
"3266",6,"HAIL","NC",2209000,4377500,0,0,6586500,0
"3267",6,"HAIL","ND",47615000,239403000,0,4,287018000,4
"3268",6,"HAIL","NE",298626000,202908100,0,63,501534100,63
"3269",6,"HAIL","NJ",12000,11000,0,0,23000,0
"3270",6,"HAIL","NM",757000,8750500,1,32,9507500,33
"3271",6,"HAIL","NV",1e+05,0,0,1,1e+05,1
"3272",6,"HAIL","NY",77257500,3512000,0,78,80769500,78
"3273",6,"HAIL","OH",707000,115529819,0,5,116236819,5
"3274",6,"HAIL","OK",18000,4623000,0,3,4641000,3
"3275",6,"HAIL","OR",50000,30053000,0,1,30103000,1
"3276",6,"HAIL","PA",52000,967100,0,1,1019100,1
"3277",6,"HAIL","PR",2000,38000,0,0,40000,0
"3278",6,"HAIL","RI",0,20000,0,0,20000,0
"3279",6,"HAIL","SC",705000,1482250,0,9,2187250,9
"3280",6,"HAIL","SD",27710000,32019750,0,27,59729750,27
"3281",6,"HAIL","TN",201000,1036590,0,6,1237590,6
"3282",6,"HAIL","TX",158774500,245921000,0,25,404695500,25
"3283",6,"HAIL","UT",29400,93000,0,0,122400,0
"3284",6,"HAIL","VA",1168000,2229000,0,0,3397000,0
"3285",6,"HAIL","VT",0,32000,0,0,32000,0
"3286",6,"HAIL","WA",74565000,241000,0,7,74806000,7
"3287",6,"HAIL","WI",2430000,547997900,0,1,550427900,1
"3288",6,"HAIL","WV",99000,12685000,0,3,12784000,3
"3289",6,"HAIL","WY",1060500,19651500,0,0,20712000,0
"3290",6,"HEAT","AK",0,0,1,0,0,1
"3291",6,"HEAT","AL",0,0,7,28,0,35
"3292",6,"HEAT","AR",0,0,2,0,0,2
"3293",6,"HEAT","AZ",0,0,1,0,0,1
"3294",6,"HEAT","CA",0,0,14,144,0,158
"3295",6,"HEAT","DE",0,0,1,15,0,16
"3296",6,"HEAT","FL",0,0,5,1,0,6
"3297",6,"HEAT","GA",0,0,3,0,0,3
"3298",6,"HEAT","IL",0,0,57,132,0,189
"3299",6,"HEAT","IN",0,0,1,0,0,1
"3300",6,"HEAT","KY",0,0,3,0,0,3
"3301",6,"HEAT","LA",0,0,15,0,0,15
"3302",6,"HEAT","MD",0,0,11,9,0,20
"3303",6,"HEAT","MI",0,0,2,2,0,4
"3304",6,"HEAT","MO",50000,0,17,212,50000,229
"3305",6,"HEAT","MS",0,0,3,0,0,3
"3306",6,"HEAT","NC",0,0,5,0,0,5
"3307",6,"HEAT","NE",0,1500000,0,0,1500000,0
"3308",6,"HEAT","NJ",0,0,0,64,0,64
"3309",6,"HEAT","NV",0,0,12,0,0,12
"3310",6,"HEAT","NY",0,0,0,50,0,50
"3311",6,"HEAT","OH",5e+06,0,0,0,5e+06,0
"3312",6,"HEAT","OK",0,0,7,6,0,13
"3313",6,"HEAT","PA",0,5000,44,9,5000,53
"3314",6,"HEAT","RI",0,0,2,0,0,2
"3315",6,"HEAT","SC",0,0,4,5,0,9
"3316",6,"HEAT","SD",0,10000,0,0,10000,0
"3317",6,"HEAT","TN",0,0,18,0,0,18
"3318",6,"HEAT","TX",50000,0,21,143,50000,164
"3319",6,"HEAT","VA",0,0,2,12,0,14
"3320",6,"HEAT","WI",0,0,11,91,0,102
"3321",6,"HEAT","WV",0,0,0,3,0,3
"3322",6,"HEAVY RAIN","AL",450000,2000,1,1,452000,2
"3323",6,"HEAVY RAIN","CA",20650000,0,0,0,20650000,0
"3324",6,"HEAVY RAIN","CO",0,115150,0,0,115150,0
"3325",6,"HEAVY RAIN","DC",0,0,0,2,0,2
"3326",6,"HEAVY RAIN","FL",0,285000,0,0,285000,0
"3327",6,"HEAVY RAIN","GA",3000,50500,0,0,53500,0
"3328",6,"HEAVY RAIN","IA",1.42e+08,426000,0,0,142426000,0
"3329",6,"HEAVY RAIN","ID",5000,85000,0,0,90000,0
"3330",6,"HEAVY RAIN","IL",0,150000,0,0,150000,0
"3331",6,"HEAVY RAIN","KS",0,505000,0,0,505000,0
"3332",6,"HEAVY RAIN","KY",0,15000,0,0,15000,0
"3333",6,"HEAVY RAIN","LA",0,25000,0,0,25000,0
"3334",6,"HEAVY RAIN","MD",0,0,1,0,0,1
"3335",6,"HEAVY RAIN","ME",5e+05,5e+05,0,0,1e+06,0
"3336",6,"HEAVY RAIN","MN",10000,30000,0,0,40000,0
"3337",6,"HEAVY RAIN","MO",1e+06,7024000,0,0,8024000,0
"3338",6,"HEAVY RAIN","MS",0,50000,0,0,50000,0
"3339",6,"HEAVY RAIN","MT",0,2000,0,0,2000,0
"3340",6,"HEAVY RAIN","NC",0,107000,0,1,107000,1
"3341",6,"HEAVY RAIN","NE",8500000,855000,0,0,9355000,0
"3342",6,"HEAVY RAIN","NJ",0,0,1,0,0,1
"3343",6,"HEAVY RAIN","OH",0,20000,0,0,20000,0
"3344",6,"HEAVY RAIN","OK",387000,0,0,0,387000,0
"3345",6,"HEAVY RAIN","OR",4e+06,0,0,0,4e+06,0
"3346",6,"HEAVY RAIN","PR",0,156000,1,0,156000,1
"3347",6,"HEAVY RAIN","SC",0,7000,0,1,7000,1
"3348",6,"HEAVY RAIN","SD",5000,3000,0,4,8000,4
"3349",6,"HEAVY RAIN","TN",0,5000,0,0,5000,0
"3350",6,"HEAVY RAIN","TX",0,90000,2,2,90000,4
"3351",6,"HEAVY RAIN","UT",31800,1897000,0,0,1928800,0
"3352",6,"HEAVY RAIN","VA",0,150000,0,0,150000,0
"3353",6,"HEAVY RAIN","WA",2.1e+07,21500,0,0,21021500,0
"3354",6,"HEAVY RAIN","WI",0,1148500,0,0,1148500,0
"3355",6,"HEAVY RAIN","WV",0,5000,0,0,5000,0
"3356",6,"HEAVY SNOW","ID",5000,0,0,0,5000,0
"3357",6,"HEAVY SNOW","MT",0,1111000,0,0,1111000,0
"3358",6,"HEAVY SNOW","UT",8200,40000,0,0,48200,0
"3359",6,"HIGH SURF","AS",0,50000,0,0,50000,0
"3360",6,"HIGH SURF","CA",0,262000,3,6,262000,9
"3361",6,"HIGH SURF","GU",0,0,6,0,0,6
"3362",6,"HIGH SURF","HI",0,0,11,9,0,20
"3363",6,"HIGH SURF","MH",0,5e+06,0,1,5e+06,1
"3364",6,"HIGH SURF","NY",0,0,4,0,0,4
"3365",6,"HIGH SURF","OR",0,5e+05,0,0,5e+05,0
"3366",6,"HIGH WIND","AK",0,10000,0,0,10000,0
"3367",6,"HIGH WIND","AL",0,13000,0,2,13000,2
"3368",6,"HIGH WIND","AR",0,3100,0,0,3100,0
"3369",6,"HIGH WIND","AZ",0,1000,0,1,1000,1
"3370",6,"HIGH WIND","CA",0,140000,1,2,140000,3
"3371",6,"HIGH WIND","CO",0,493500,1,8,493500,9
"3372",6,"HIGH WIND","DC",0,5000,0,0,5000,0
"3373",6,"HIGH WIND","FL",0,30000,0,0,30000,0
"3374",6,"HIGH WIND","IA",210000,1747200,0,1,1957200,1
"3375",6,"HIGH WIND","ID",0,115000,0,0,115000,0
"3376",6,"HIGH WIND","IL",0,10000,0,0,10000,0
"3377",6,"HIGH WIND","KS",5500,217000,0,0,222500,0
"3378",6,"HIGH WIND","KY",0,50000,0,0,50000,0
"3379",6,"HIGH WIND","MD",0,0,0,4,0,4
"3380",6,"HIGH WIND","MI",0,115000,0,0,115000,0
"3381",6,"HIGH WIND","MN",150000,150000,0,0,3e+05,0
"3382",6,"HIGH WIND","MO",0,4000,0,0,4000,0
"3383",6,"HIGH WIND","MS",0,10000,0,0,10000,0
"3384",6,"HIGH WIND","MT",0,505000,0,1,505000,1
"3385",6,"HIGH WIND","NC",0,10000,0,0,10000,0
"3386",6,"HIGH WIND","ND",2e+05,310000,0,0,510000,0
"3387",6,"HIGH WIND","NE",0,95000,0,0,95000,0
"3388",6,"HIGH WIND","NJ",0,50000,0,0,50000,0
"3389",6,"HIGH WIND","NM",0,851000,0,0,851000,0
"3390",6,"HIGH WIND","NV",0,450015,1,0,450015,1
"3391",6,"HIGH WIND","NY",0,75000,0,11,75000,11
"3392",6,"HIGH WIND","OH",0,3000,0,15,3000,15
"3393",6,"HIGH WIND","OK",0,150250,0,0,150250,0
"3394",6,"HIGH WIND","OR",0,192000,0,1,192000,1
"3395",6,"HIGH WIND","SD",0,35000,0,0,35000,0
"3396",6,"HIGH WIND","TX",0,6345000,0,0,6345000,0
"3397",6,"HIGH WIND","UT",1207000,15798700,1,10,17005700,11
"3398",6,"HIGH WIND","VA",0,30000,0,0,30000,0
"3399",6,"HIGH WIND","WA",0,55500,0,0,55500,0
"3400",6,"HIGH WIND","WI",0,40000,0,0,40000,0
"3401",6,"HIGH WIND","WY",0,84000,0,3,84000,3
"3402",6,"HURRICANE/TYPHOON","GU",1270000,3900000,0,0,5170000,0
"3403",6,"LIGHTNING","AL",1000,3949750,6,32,3950750,38
"3404",6,"LIGHTNING","AR",0,3751010,2,27,3751010,29
"3405",6,"LIGHTNING","AZ",0,5000,0,6,5000,6
"3406",6,"LIGHTNING","CA",0,239000,2,7,239000,9
"3407",6,"LIGHTNING","CO",37800,1850800,5,59,1888600,64
"3408",6,"LIGHTNING","CT",0,464000,2,17,464000,19
"3409",6,"LIGHTNING","DC",0,25000,0,12,25000,12
"3410",6,"LIGHTNING","DE",0,1125500,0,0,1125500,0
"3411",6,"LIGHTNING","FL",1000,12613750,28,173,12614750,201
"3412",6,"LIGHTNING","GA",50000,19441500,7,62,19491500,69
"3413",6,"LIGHTNING","GU",0,72000,0,0,72000,0
"3414",6,"LIGHTNING","HI",0,20000,0,0,20000,0
"3415",6,"LIGHTNING","IA",0,5579200,3,9,5579200,12
"3416",6,"LIGHTNING","ID",0,1102000,1,3,1102000,4
"3417",6,"LIGHTNING","IL",0,2686800,8,19,2686800,27
"3418",6,"LIGHTNING","IN",0,9102000,3,31,9102000,34
"3419",6,"LIGHTNING","KS",0,2498000,3,11,2498000,14
"3420",6,"LIGHTNING","KY",0,3567500,3,7,3567500,10
"3421",6,"LIGHTNING","LA",0,3641000,5,14,3641000,19
"3422",6,"LIGHTNING","MA",0,8340000,2,48,8340000,50
"3423",6,"LIGHTNING","MD",0,6699300,6,32,6699300,38
"3424",6,"LIGHTNING","ME",0,1732500,1,10,1732500,11
"3425",6,"LIGHTNING","MI",0,3861500,6,32,3861500,38
"3426",6,"LIGHTNING","MN",0,3321900,4,11,3321900,15
"3427",6,"LIGHTNING","MO",0,2074000,5,12,2074000,17
"3428",6,"LIGHTNING","MS",7000,1969800,2,9,1976800,11
"3429",6,"LIGHTNING","MT",0,90000,4,4,90000,8
"3430",6,"LIGHTNING","NC",0,10916400,8,61,10916400,69
"3431",6,"LIGHTNING","ND",0,403000,0,2,403000,2
"3432",6,"LIGHTNING","NE",0,2232000,1,2,2232000,3
"3433",6,"LIGHTNING","NH",0,1686500,1,11,1686500,12
"3434",6,"LIGHTNING","NJ",0,4960000,2,28,4960000,30
"3435",6,"LIGHTNING","NM",0,130000,0,1,130000,1
"3436",6,"LIGHTNING","NV",0,513000,0,0,513000,0
"3437",6,"LIGHTNING","NY",1000,2969500,4,77,2970500,81
"3438",6,"LIGHTNING","OH",3505000,6492000,12,91,9997000,103
"3439",6,"LIGHTNING","OK",0,12580300,3,6,12580300,9
"3440",6,"LIGHTNING","OR",0,1666000,0,4,1666000,4
"3441",6,"LIGHTNING","PA",0,3880721,9,72,3880721,81
"3442",6,"LIGHTNING","PR",0,0,1,0,0,1
"3443",6,"LIGHTNING","RI",0,6e+05,0,2,6e+05,2
"3444",6,"LIGHTNING","SC",0,8915000,6,30,8915000,36
"3445",6,"LIGHTNING","SD",0,834200,2,3,834200,5
"3446",6,"LIGHTNING","TN",0,3548900,2,4,3548900,6
"3447",6,"LIGHTNING","TX",0,11794810,7,21,11794810,28
"3448",6,"LIGHTNING","UT",0,353000,0,2,353000,2
"3449",6,"LIGHTNING","VA",0,2984100,7,28,2984100,35
"3450",6,"LIGHTNING","VT",0,427000,1,4,427000,5
"3451",6,"LIGHTNING","WA",0,24000,0,6,24000,6
"3452",6,"LIGHTNING","WI",0,2782000,3,39,2782000,42
"3453",6,"LIGHTNING","WV",0,460000,2,13,460000,15
"3454",6,"LIGHTNING","WY",0,227000,2,32,227000,34
"3455",6,"MARINE STRONG WIND","LM",0,2000,1,0,2000,1
"3456",6,"MARINE THUNDERSTORM WIND","AM",50000,0,4,5,50000,9
"3457",6,"MARINE THUNDERSTORM WIND","AN",0,115000,1,0,115000,1
"3458",6,"MARINE THUNDERSTORM WIND","CA",2.9e+07,175000,0,0,29175000,0
"3459",6,"MARINE THUNDERSTORM WIND","GM",0,8000,0,0,8000,0
"3460",6,"MARINE THUNDERSTORM WIND","LM",0,15000,0,0,15000,0
"3461",6,"MARINE THUNDERSTORM WIND","LO",0,30000,0,0,30000,0
"3462",6,"MARINE THUNDERSTORM WIND","LS",0,4e+05,0,0,4e+05,0
"3463",6,"MARINE THUNDERSTORM WIND","SL",0,15000,0,0,15000,0
"3464",6,"RIP CURRENT","AL",0,0,3,0,0,3
"3465",6,"RIP CURRENT","AS",0,0,1,1,0,2
"3466",6,"RIP CURRENT","CA",0,0,5,5,0,10
"3467",6,"RIP CURRENT","FL",0,0,40,27,0,67
"3468",6,"RIP CURRENT","GA",0,0,1,4,0,5
"3469",6,"RIP CURRENT","GU",0,0,5,0,0,5
"3470",6,"RIP CURRENT","NC",0,0,5,3,0,8
"3471",6,"RIP CURRENT","NJ",0,0,3,1,0,4
"3472",6,"RIP CURRENT","NY",0,0,7,0,0,7
"3473",6,"RIP CURRENT","SC",0,0,5,0,0,5
"3474",6,"RIP CURRENT","TX",0,0,6,0,0,6
"3475",6,"STORM SURGE/TIDE","FL",0,280000,0,0,280000,0
"3476",6,"STORM SURGE/TIDE","LA",0,4100000,0,0,4100000,0
"3477",6,"STORM SURGE/TIDE","MS",0,1e+06,0,0,1e+06,0
"3478",6,"STORM SURGE/TIDE","NY",0,16000,0,0,16000,0
"3479",6,"STORM SURGE/TIDE","OH",0,525000,0,0,525000,0
"3480",6,"STORM SURGE/TIDE","TX",0,25000,0,0,25000,0
"3481",6,"STRONG WIND","AK",0,100,0,0,100,0
"3482",6,"STRONG WIND","AL",0,106000,0,0,106000,0
"3483",6,"STRONG WIND","CA",2000,275300,0,7,277300,7
"3484",6,"STRONG WIND","CO",0,132000,0,1,132000,1
"3485",6,"STRONG WIND","DC",0,0,0,4,0,4
"3486",6,"STRONG WIND","GA",0,22000,0,0,22000,0
"3487",6,"STRONG WIND","IA",0,50,0,0,50,0
"3488",6,"STRONG WIND","IL",0,78000,0,0,78000,0
"3489",6,"STRONG WIND","KS",0,30000,0,0,30000,0
"3490",6,"STRONG WIND","LA",0,200,0,0,200,0
"3491",6,"STRONG WIND","MA",0,40000,0,1,40000,1
"3492",6,"STRONG WIND","MD",0,11500,0,0,11500,0
"3493",6,"STRONG WIND","ME",0,40000,0,0,40000,0
"3494",6,"STRONG WIND","MI",0,52250,0,0,52250,0
"3495",6,"STRONG WIND","MN",0,3000,2,0,3000,2
"3496",6,"STRONG WIND","MO",0,17000,0,0,17000,0
"3497",6,"STRONG WIND","MS",0,259210,0,0,259210,0
"3498",6,"STRONG WIND","NC",0,50000,1,0,50000,1
"3499",6,"STRONG WIND","NE",0,725000,0,0,725000,0
"3500",6,"STRONG WIND","NM",0,9500,0,0,9500,0
"3501",6,"STRONG WIND","NY",0,6000,0,0,6000,0
"3502",6,"STRONG WIND","OK",0,5000,0,0,5000,0
"3503",6,"STRONG WIND","PA",0,5000,0,0,5000,0
"3504",6,"STRONG WIND","PR",0,6000,0,0,6000,0
"3505",6,"STRONG WIND","SC",0,57000,0,0,57000,0
"3506",6,"STRONG WIND","TN",0,24000,0,0,24000,0
"3507",6,"STRONG WIND","TX",0,33000,0,0,33000,0
"3508",6,"STRONG WIND","UT",0,22000,0,0,22000,0
"3509",6,"STRONG WIND","VA",0,11000,0,0,11000,0
"3510",6,"STRONG WIND","VT",0,112000,1,0,112000,1
"3511",6,"STRONG WIND","WA",0,61000,0,0,61000,0
"3512",6,"STRONG WIND","WI",0,62750,0,3,62750,3
"3513",6,"STRONG WIND","WV",0,2000,0,0,2000,0
"3514",6,"THUNDERSTORM WIND","AK",0,5000,0,0,5000,0
"3515",6,"THUNDERSTORM WIND","AL",1296000,26098800,4,47,27394800,51
"3516",6,"THUNDERSTORM WIND","AR",0,29200710,2,26,29200710,28
"3517",6,"THUNDERSTORM WIND","AZ",10000,3647000,6,4,3657000,10
"3518",6,"THUNDERSTORM WIND","CA",0,58000,1,0,58000,1
"3519",6,"THUNDERSTORM WIND","CO",18005000,6398950,4,13,24403950,17
"3520",6,"THUNDERSTORM WIND","CT",0,5808500,3,40,5808500,43
"3521",6,"THUNDERSTORM WIND","DC",0,944000,0,14,944000,14
"3522",6,"THUNDERSTORM WIND","DE",201000,2402000,0,1,2603000,1
"3523",6,"THUNDERSTORM WIND","FL",5500,16807250,2,37,16812750,39
"3524",6,"THUNDERSTORM WIND","GA",280500,31665470,1,58,31945970,59
"3525",6,"THUNDERSTORM WIND","IA",17720300,170915100,7,127,188635400,134
"3526",6,"THUNDERSTORM WIND","ID",0,1470700,0,30,1470700,30
"3527",6,"THUNDERSTORM WIND","IL",60244000,46922448,3,108,107166448,111
"3528",6,"THUNDERSTORM WIND","IN",52000,13914300.1,10,51,13966300.1,61
"3529",6,"THUNDERSTORM WIND","KS",12358500,46790450,0,114,59148950,114
"3530",6,"THUNDERSTORM WIND","KY",18050,11890850,1,15,11908900,16
"3531",6,"THUNDERSTORM WIND","LA",50000,10749100,2,36,10799100,38
"3532",6,"THUNDERSTORM WIND","MA",0,3874750,4,23,3874750,27
"3533",6,"THUNDERSTORM WIND","MD",30000,7996700,2,13,8026700,15
"3534",6,"THUNDERSTORM WIND","ME",0,0,1,1,0,2
"3535",6,"THUNDERSTORM WIND","MI",258000,26026750,7,39,26284750,46
"3536",6,"THUNDERSTORM WIND","MN",16161900,56829900,1,29,72991800,30
"3537",6,"THUNDERSTORM WIND","MO",6032500,11394976,1,25,17427476,26
"3538",6,"THUNDERSTORM WIND","MS",280000,25448450,6,68,25728450,74
"3539",6,"THUNDERSTORM WIND","MT",1570000,14617500,1,6,16187500,7
"3540",6,"THUNDERSTORM WIND","NC",109500,5796400,3,21,5905900,24
"3541",6,"THUNDERSTORM WIND","ND",4585000,50415600,2,21,55000600,23
"3542",6,"THUNDERSTORM WIND","NE",83865000,74574500,0,16,158439500,16
"3543",6,"THUNDERSTORM WIND","NH",0,521000,1,2,521000,3
"3544",6,"THUNDERSTORM WIND","NJ",1e+06,14728000,4,24,15728000,28
"3545",6,"THUNDERSTORM WIND","NM",1000,3138000,0,17,3139000,17
"3546",6,"THUNDERSTORM WIND","NV",0,54200,0,0,54200,0
"3547",6,"THUNDERSTORM WIND","NY",27000,15085250,10,86,15112250,96
"3548",6,"THUNDERSTORM WIND","OH",2372000,51121010,10,48,53493010,58
"3549",6,"THUNDERSTORM WIND","OK",0,784352150,0,36,784352150,36
"3550",6,"THUNDERSTORM WIND","OR",160000,389150,0,3,549150,3
"3551",6,"THUNDERSTORM WIND","PA",25000,78477000,5,78,78502000,83
"3552",6,"THUNDERSTORM WIND","PR",0,84000,0,0,84000,0
"3553",6,"THUNDERSTORM WIND","RI",0,900500,0,0,900500,0
"3554",6,"THUNDERSTORM WIND","SC",2000,17095600,5,40,17097600,45
"3555",6,"THUNDERSTORM WIND","SD",180000,14959300,2,17,15139300,19
"3556",6,"THUNDERSTORM WIND","TN",2095500,27398250,2,33,29493750,35
"3557",6,"THUNDERSTORM WIND","TX",15940050,165528440,6,94,181468490,100
"3558",6,"THUNDERSTORM WIND","UT",126800,1654200,0,2,1781000,2
"3559",6,"THUNDERSTORM WIND","VA",501000,16289700,1,54,16790700,55
"3560",6,"THUNDERSTORM WIND","VI",0,55000,0,0,55000,0
"3561",6,"THUNDERSTORM WIND","VT",10000,2717500,0,4,2727500,4
"3562",6,"THUNDERSTORM WIND","WA",2000,72000,0,12,74000,12
"3563",6,"THUNDERSTORM WIND","WI",3001900,46897850,3,54,49899750,57
"3564",6,"THUNDERSTORM WIND","WV",0,9942750,1,11,9942750,12
"3565",6,"THUNDERSTORM WIND","WY",1000,1118200,0,7,1119200,7
"3566",6,"TORNADO","AL",5000,13955530,0,37,13960530,37
"3567",6,"TORNADO","AR",10000,34322250,5,170,34332250,175
"3568",6,"TORNADO","AZ",0,28102500,1,56,28102500,57
"3569",6,"TORNADO","CA",50000,25025280,0,0,25075280,0
"3570",6,"TORNADO","CO",0,103038410,2,106,103038410,108
"3571",6,"TORNADO","CT",0,7227780,0,12,7227780,12
"3572",6,"TORNADO","DE",0,7776000,0,32,7776000,32
"3573",6,"TORNADO","FL",16000,39585980,6,206,39601980,212
"3574",6,"TORNADO","GA",0,46610280,6,289,46610280,295
"3575",6,"TORNADO","HI",0,25000,0,0,25000,0
"3576",6,"TORNADO","IA",642100,504856490,20,536,505498590,556
"3577",6,"TORNADO","ID",10000,691900,0,4,701900,4
"3578",6,"TORNADO","IL",187000,178911060,11,293,179098060,304
"3579",6,"TORNADO","IN",225000,187405090,11,339,187630090,350
"3580",6,"TORNADO","KS",7e+05,549727830,68,1042,550427830,1110
"3581",6,"TORNADO","KY",10000,49627500,1,137,49637500,138
"3582",6,"TORNADO","LA",0,20738620,3,130,20738620,133
"3583",6,"TORNADO","MA",0,713403030,96,1666,713403030,1762
"3584",6,"TORNADO","MD",315000,11243250,0,24,11558250,24
"3585",6,"TORNADO","ME",0,1455250,0,7,1455250,7
"3586",6,"TORNADO","MI",150000,184699180,131,960,184849180,1091
"3587",6,"TORNADO","MN",2052050,308163100,17,487,310215150,504
"3588",6,"TORNADO","MO",5000,71113380,9,110,71118380,119
"3589",6,"TORNADO","MS",0,8357560,4,41,8357560,45
"3590",6,"TORNADO","MT",50000,38060530,0,2,38110530,2
"3591",6,"TORNADO","NC",0,14771780,1,26,14771780,27
"3592",6,"TORNADO","ND",350000,49321120,12,138,49671120,150
"3593",6,"TORNADO","NE",14405050,466009310,24,473,480414360,497
"3594",6,"TORNADO","NH",0,3335750,0,6,3335750,6
"3595",6,"TORNADO","NJ",0,3930000,0,1,3930000,1
"3596",6,"TORNADO","NM",5000,2700020,0,57,2705020,57
"3597",6,"TORNADO","NV",0,277810,0,0,277810,0
"3598",6,"TORNADO","NY",15000,42594030,2,24,42609030,26
"3599",6,"TORNADO","OH",5011500,375494310,30,600,380505810,630
"3600",6,"TORNADO","OK",0,169031110,25,454,169031110,479
"3601",6,"TORNADO","OR",0,25293600,0,0,25293600,0
"3602",6,"TORNADO","PA",7070000,799208560,3,249,806278560,252
"3603",6,"TORNADO","PR",0,65000,0,0,65000,0
"3604",6,"TORNADO","SC",1e+05,11120810,0,25,11220810,25
"3605",6,"TORNADO","SD",500,114090500,7,144,114091000,151
"3606",6,"TORNADO","TN",177000,11995750,3,36,12172750,39
"3607",6,"TORNADO","TX",75061500,253761250,18,347,328822750,365
"3608",6,"TORNADO","UT",1000,45030,0,0,46030,0
"3609",6,"TORNADO","VA",81000,10877560,0,13,10958560,13
"3610",6,"TORNADO","VT",0,707000,0,1,707000,1
"3611",6,"TORNADO","WA",0,227850,0,1,227850,1
"3612",6,"TORNADO","WI",4514500,318843480,47,535,323357980,582
"3613",6,"TORNADO","WV",2275000,12721030,1,27,14996030,28
"3614",6,"TORNADO","WY",0,7108170,1,25,7108170,26
"3615",6,"TROPICAL STORM","AL",0,1500000,0,0,1500000,0
"3616",6,"TROPICAL STORM","FL",25000,4990000,0,0,5015000,0
"3617",6,"TROPICAL STORM","LA",0,3.4e+07,0,0,3.4e+07,0
"3618",6,"TROPICAL STORM","MS",0,1545000,0,0,1545000,0
"3619",6,"TROPICAL STORM","NC",1e+06,1e+06,0,0,2e+06,0
"3620",6,"TROPICAL STORM","TX",0,5150125000,22,0,5150125000,22
"3621",6,"WATERSPOUT","FL",0,1055000,0,1,1055000,1
"3622",6,"WATERSPOUT","GM",0,5000,0,0,5000,0
"3623",6,"WATERSPOUT","OH",0,10000,0,0,10000,0
"3624",6,"WILDFIRE","AK",10000,11640000,0,0,11650000,0
"3625",6,"WILDFIRE","AZ",0,135125000,0,0,135125000,0
"3626",6,"WILDFIRE","CA",10000,517222000,1,66,517232000,67
"3627",6,"WILDFIRE","CO",0,37568000,0,2,37568000,2
"3628",6,"WILDFIRE","FL",0,60000,0,3,60000,3
"3629",6,"WILDFIRE","HI",0,0,0,2,0,2
"3630",6,"WILDFIRE","ID",0,0,0,1,0,1
"3631",6,"WILDFIRE","LA",270000,70000,0,1,340000,1
"3632",6,"WILDFIRE","MI",0,5050000,0,0,5050000,0
"3633",6,"WILDFIRE","NC",0,5e+05,0,0,5e+05,0
"3634",6,"WILDFIRE","NJ",0,7e+05,0,0,7e+05,0
"3635",6,"WILDFIRE","NM",0,58850000,0,0,58850000,0
"3636",6,"WILDFIRE","NV",0,10000,0,0,10000,0
"3637",6,"WILDFIRE","OK",0,180000,0,0,180000,0
"3638",6,"WILDFIRE","OR",123900,510000,0,3,633900,3
"3639",6,"WILDFIRE","TX",17282400,2136500,0,14,19418900,14
"3640",6,"WILDFIRE","UT",0,5e+05,6,0,5e+05,6
"3641",6,"WILDFIRE","WA",0,61000,0,0,61000,0
"3642",6,"WILDFIRE","WI",0,50000,0,0,50000,0
"3643",6,"WINTER STORM","CA",0,25000,0,0,25000,0
"3644",6,"WINTER STORM","MT",0,3200000,0,0,3200000,0
"3645",6,"WINTER WEATHER","WA",0,2000,1,2,2000,3
"3646",7,"BLIZZARD","CA",0,50000,0,0,50000,0
"3647",7,"COASTAL FLOOD","AK",0,8e+05,0,0,8e+05,0
"3648",7,"COASTAL FLOOD","FL",0,1750000,0,0,1750000,0
"3649",7,"DEBRIS FLOW","AZ",0,10000,0,0,10000,0
"3650",7,"DEBRIS FLOW","CA",0,2000,0,0,2000,0
"3651",7,"DEBRIS FLOW","CO",0,31000,1,2,31000,3
"3652",7,"DEBRIS FLOW","IL",0,50000,0,0,50000,0
"3653",7,"DEBRIS FLOW","NC",0,1e+05,0,0,1e+05,0
"3654",7,"DEBRIS FLOW","NY",0,25000,0,0,25000,0
"3655",7,"DEBRIS FLOW","PA",0,15000,0,0,15000,0
"3656",7,"DEBRIS FLOW","VA",0,10000,0,0,10000,0
"3657",7,"DEBRIS FLOW","WY",0,275000,0,0,275000,0
"3658",7,"DENSE FOG","KS",0,0,2,3,0,5
"3659",7,"DENSE FOG","SC",0,20000,0,3,20000,3
"3660",7,"DROUGHT","AR",550000,0,0,0,550000,0
"3661",7,"DROUGHT","IA",264610000,0,0,0,264610000,0
"3662",7,"DROUGHT","IL",180110000,0,0,0,180110000,0
"3663",7,"DROUGHT","KS",4004000,0,0,0,4004000,0
"3664",7,"DROUGHT","LA",5e+05,0,0,0,5e+05,0
"3665",7,"DROUGHT","MD",43680000,0,0,0,43680000,0
"3666",7,"DROUGHT","MI",1.5e+08,0,0,0,1.5e+08,0
"3667",7,"DROUGHT","MO",8490000,0,0,0,8490000,0
"3668",7,"DROUGHT","MS",5e+05,50000,0,0,550000,0
"3669",7,"DROUGHT","OK",500750000,50000,0,0,500800000,0
"3670",7,"DROUGHT","PA",5e+08,0,0,0,5e+08,0
"3671",7,"DROUGHT","TX",335120000,20008000,0,0,355128000,0
"3672",7,"DROUGHT","VA",9.5e+07,0,0,0,9.5e+07,0
"3673",7,"DROUGHT","WI",50000,0,0,0,50000,0
"3674",7,"DROUGHT","WV",12400000,0,0,0,12400000,0
"3675",7,"DUST DEVIL","AL",0,20000,0,0,20000,0
"3676",7,"DUST DEVIL","AZ",0,25000,0,0,25000,0
"3677",7,"DUST DEVIL","MD",0,1000,0,1,1000,1
"3678",7,"DUST DEVIL","MT",0,40000,0,0,40000,0
"3679",7,"DUST DEVIL","NM",0,5000,0,0,5000,0
"3680",7,"DUST DEVIL","NV",0,61000,0,0,61000,0
"3681",7,"DUST DEVIL","OK",0,15000,0,0,15000,0
"3682",7,"DUST DEVIL","PA",0,5000,0,0,5000,0
"3683",7,"DUST DEVIL","SD",0,3500,0,0,3500,0
"3684",7,"DUST DEVIL","WI",0,100,0,0,100,0
"3685",7,"DUST STORM","AZ",0,555000,1,65,555000,66
"3686",7,"DUST STORM","NM",0,30000,0,8,30000,8
"3687",7,"DUST STORM","NV",0,0,0,30,0,30
"3688",7,"DUST STORM","TX",750000,90000,0,2,840000,2
"3689",7,"DUST STORM","WA",0,0,1,14,0,15
"3690",7,"FLASH FLOOD","AK",0,5000,0,0,5000,0
"3691",7,"FLASH FLOOD","AL",212000,4500000,1,3,4712000,4
"3692",7,"FLASH FLOOD","AR",0,3364020,0,7,3364020,7
"3693",7,"FLASH FLOOD","AZ",0,28230000,10,22,28230000,32
"3694",7,"FLASH FLOOD","CA",0,29020000,2,11,29020000,13
"3695",7,"FLASH FLOOD","CO",865000,219067000,8,54,219932000,62
"3696",7,"FLASH FLOOD","CT",0,1415500,0,0,1415500,0
"3697",7,"FLASH FLOOD","DE",0,780000,0,2,780000,2
"3698",7,"FLASH FLOOD","FL",0,1768000,0,0,1768000,0
"3699",7,"FLASH FLOOD","GA",117000,29315750,4,6,29432750,10
"3700",7,"FLASH FLOOD","GU",0,410000,0,0,410000,0
"3701",7,"FLASH FLOOD","HI",0,49000,1,1,49000,2
"3702",7,"FLASH FLOOD","IA",7611500,73664000,1,3,81275500,4
"3703",7,"FLASH FLOOD","ID",0,1314000,1,1,1314000,2
"3704",7,"FLASH FLOOD","IL",16120000,391759500,2,2,407879500,4
"3705",7,"FLASH FLOOD","IN",120000,44713000,2,0,44833000,2
"3706",7,"FLASH FLOOD","KS",581000,151651800,1,0,152232800,1
"3707",7,"FLASH FLOOD","KY",16200000,20072000,2,1,36272000,3
"3708",7,"FLASH FLOOD","LA",0,3233000,0,0,3233000,0
"3709",7,"FLASH FLOOD","MA",0,14034000,0,0,14034000,0
"3710",7,"FLASH FLOOD","MD",0,4147000,0,0,4147000,0
"3711",7,"FLASH FLOOD","ME",5000,4089000,0,2,4094000,2
"3712",7,"FLASH FLOOD","MI",510000,8800000,0,0,9310000,0
"3713",7,"FLASH FLOOD","MN",3406000,24761000,1,1,28167000,2
"3714",7,"FLASH FLOOD","MO",70000,11656620,8,9,11726620,17
"3715",7,"FLASH FLOOD","MS",155000,8558000,0,0,8713000,0
"3716",7,"FLASH FLOOD","MT",335000,2769000,0,0,3104000,0
"3717",7,"FLASH FLOOD","NC",10810000,25144868,6,8,35954868,14
"3718",7,"FLASH FLOOD","ND",340000,2887000,0,0,3227000,0
"3719",7,"FLASH FLOOD","NE",10832000,12075500,2,0,22907500,2
"3720",7,"FLASH FLOOD","NH",0,150000,1,0,150000,1
"3721",7,"FLASH FLOOD","NJ",0,71360000,2,2,71360000,4
"3722",7,"FLASH FLOOD","NM",482000,9770000,8,3,10252000,11
"3723",7,"FLASH FLOOD","NV",0,26461000,2,5,26461000,7
"3724",7,"FLASH FLOOD","NY",1370000,86017000,0,4,87387000,4
"3725",7,"FLASH FLOOD","OH",5340000,669584810,14,5,674924810,19
"3726",7,"FLASH FLOOD","OK",0,2913000,3,0,2913000,3
"3727",7,"FLASH FLOOD","OR",0,1016000,0,0,1016000,0
"3728",7,"FLASH FLOOD","PA",10000,320092000,6,6,320102000,12
"3729",7,"FLASH FLOOD","PR",0,878000,2,0,878000,2
"3730",7,"FLASH FLOOD","RI",0,155000,0,0,155000,0
"3731",7,"FLASH FLOOD","SC",0,6538500,0,1,6538500,1
"3732",7,"FLASH FLOOD","SD",5e+07,7385000,0,4,57385000,4
"3733",7,"FLASH FLOOD","TN",11000,10500020,4,26,10511020,30
"3734",7,"FLASH FLOOD","TX",60500,71950500,10,2,72011000,12
"3735",7,"FLASH FLOOD","UT",543700,3305000,5,6,3848700,11
"3736",7,"FLASH FLOOD","VA",0,19634000,3,1,19634000,4
"3737",7,"FLASH FLOOD","VT",25000,21672500,0,0,21697500,0
"3738",7,"FLASH FLOOD","WA",0,2084000,1,2,2084000,3
"3739",7,"FLASH FLOOD","WI",11341000,64915500,1,2,76256500,3
"3740",7,"FLASH FLOOD","WV",5000,221884000,3,0,221889000,3
"3741",7,"FLASH FLOOD","WY",2000,7392000,4,6,7394000,10
"3742",7,"FLOOD","AK",0,13507000,0,0,13507000,0
"3743",7,"FLOOD","AL",5050000,50518000,2,0,55568000,2
"3744",7,"FLOOD","AR",40000,11000,0,0,51000,0
"3745",7,"FLOOD","AZ",0,3612000,0,0,3612000,0
"3746",7,"FLOOD","CA",0,1305000,1,4,1305000,5
"3747",7,"FLOOD","CO",2000,13002000,0,0,13004000,0
"3748",7,"FLOOD","CT",0,27000,0,0,27000,0
"3749",7,"FLOOD","FL",5e+07,11146500,0,0,61146500,0
"3750",7,"FLOOD","GA",11232000,68754000,24,9,79986000,33
"3751",7,"FLOOD","IA",49250000,75427000,0,0,124677000,0
"3752",7,"FLOOD","ID",0,277000,0,0,277000,0
"3753",7,"FLOOD","IL",165000,3095000,1,0,3260000,1
"3754",7,"FLOOD","IN",102059000,101597000,1,1,203656000,2
"3755",7,"FLOOD","KS",2755000,24805300,0,0,27560300,0
"3756",7,"FLOOD","KY",0,135000,0,0,135000,0
"3757",7,"FLOOD","LA",0,3307000,0,0,3307000,0
"3758",7,"FLOOD","MA",0,104000,0,0,104000,0
"3759",7,"FLOOD","MD",0,83000,0,0,83000,0
"3760",7,"FLOOD","ME",0,1e+06,0,0,1e+06,0
"3761",7,"FLOOD","MI",5e+06,5055000,0,0,10055000,0
"3762",7,"FLOOD","MN",625000,1040000,0,0,1665000,0
"3763",7,"FLOOD","MO",517114000,3553050,0,0,520667050,0
"3764",7,"FLOOD","MS",0,1217500,0,0,1217500,0
"3765",7,"FLOOD","MT",0,605000,0,0,605000,0
"3766",7,"FLOOD","NC",0,10000,0,4,10000,4
"3767",7,"FLOOD","ND",4060000,11865000,0,0,15925000,0
"3768",7,"FLOOD","NE",9135000,4898000,0,0,14033000,0
"3769",7,"FLOOD","NH",0,92000,0,0,92000,0
"3770",7,"FLOOD","NJ",0,3e+06,0,3,3e+06,3
"3771",7,"FLOOD","NM",1000,30135000,1,0,30136000,1
"3772",7,"FLOOD","NV",6e+06,562000,0,0,6562000,0
"3773",7,"FLOOD","NY",1e+05,4014000,2,0,4114000,2
"3774",7,"FLOOD","OH",2e+06,61337000,2,0,63337000,2
"3775",7,"FLOOD","OK",0,21280000,0,0,21280000,0
"3776",7,"FLOOD","PA",0,5723000,0,0,5723000,0
"3777",7,"FLOOD","RI",0,40000,0,0,40000,0
"3778",7,"FLOOD","SC",0,2020000,0,0,2020000,0
"3779",7,"FLOOD","SD",22320000,498100,0,0,22818100,0
"3780",7,"FLOOD","TN",0,243500,0,0,243500,0
"3781",7,"FLOOD","TX",24845000,122505000,5,3,147350000,8
"3782",7,"FLOOD","UT",0,190000,0,0,190000,0
"3783",7,"FLOOD","VA",0,20000,0,0,20000,0
"3784",7,"FLOOD","VT",0,2285000,0,1,2285000,1
"3785",7,"FLOOD","WA",0,125000,0,0,125000,0
"3786",7,"FLOOD","WI",5000,2021750,0,0,2026750,0
"3787",7,"FLOOD","WV",0,791000,0,0,791000,0
"3788",7,"FLOOD","WY",520000,955500,0,0,1475500,0
"3789",7,"FUNNEL CLOUD","FL",0,5000,0,0,5000,0
"3790",7,"FUNNEL CLOUD","SD",0,0,0,1,0,1
"3791",7,"HAIL","AL",17000,140000,0,0,157000,0
"3792",7,"HAIL","AR",52500,50140290,0,36,50192790,36
"3793",7,"HAIL","AZ",0,285800,0,0,285800,0
"3794",7,"HAIL","CA",5000,38000,0,0,43000,0
"3795",7,"HAIL","CO",51546500,627416800,0,71,678963300,71
"3796",7,"HAIL","CT",0,4500,0,0,4500,0
"3797",7,"HAIL","FL",0,294050,1,4,294050,5
"3798",7,"HAIL","GA",200,4974050,0,0,4974250,0
"3799",7,"HAIL","IA",47752300,21135500,0,0,68887800,0
"3800",7,"HAIL","ID",5562000,180000,0,1,5742000,1
"3801",7,"HAIL","IL",145000,720550,0,1,865550,1
"3802",7,"HAIL","IN",15000,188600,0,0,203600,0
"3803",7,"HAIL","KS",52000500,89412950,0,21,141413450,21
"3804",7,"HAIL","KY",618000,92000,0,1,710000,1
"3805",7,"HAIL","LA",0,1000,0,0,1000,0
"3806",7,"HAIL","MA",0,242250,0,0,242250,0
"3807",7,"HAIL","MD",515000,26000,0,10,541000,10
"3808",7,"HAIL","ME",130000,5e+05,0,2,630000,2
"3809",7,"HAIL","MI",10005000,9248000,0,4,19253000,4
"3810",7,"HAIL","MN",79137000,4233850,0,3,83370850,3
"3811",7,"HAIL","MO",547000,734870,0,0,1281870,0
"3812",7,"HAIL","MS",0,314150,0,1,314150,1
"3813",7,"HAIL","MT",4936000,16564700,0,6,21500700,6
"3814",7,"HAIL","NC",1975000,2251000,0,0,4226000,0
"3815",7,"HAIL","ND",116045030,126288000,0,9,242333030,9
"3816",7,"HAIL","NE",281070250,88537000,0,20,369607250,20
"3817",7,"HAIL","NH",0,1000,0,0,1000,0
"3818",7,"HAIL","NM",10000,91500,0,0,101500,0
"3819",7,"HAIL","NV",0,10000,0,0,10000,0
"3820",7,"HAIL","NY",5791100,1089500,0,5,6880600,5
"3821",7,"HAIL","OH",1909000,33753010,0,2,35662010,2
"3822",7,"HAIL","OK",150000,667500,0,0,817500,0
"3823",7,"HAIL","OR",33700000,25651200,0,3,59351200,3
"3824",7,"HAIL","PA",3425000,657000,0,0,4082000,0
"3825",7,"HAIL","PR",0,30500,0,1,30500,1
"3826",7,"HAIL","SC",0,778250,0,1,778250,1
"3827",7,"HAIL","SD",43860000,33848000,0,29,77708000,29
"3828",7,"HAIL","TN",536000,1492300,0,0,2028300,0
"3829",7,"HAIL","TX",10389000,4526500,0,0,14915500,0
"3830",7,"HAIL","UT",35200,122000,0,8,157200,8
"3831",7,"HAIL","VA",688000,665500,0,0,1353500,0
"3832",7,"HAIL","VT",260000,292000,0,0,552000,0
"3833",7,"HAIL","WA",86720000,10159000,0,0,96879000,0
"3834",7,"HAIL","WI",38929250,30784350,0,2,69713600,2
"3835",7,"HAIL","WV",18000,796500,0,0,814500,0
"3836",7,"HAIL","WY",325000,11527000,0,9,11852000,9
"3837",7,"HEAT","AL",0,0,8,4,0,12
"3838",7,"HEAT","AR",0,0,18,7,0,25
"3839",7,"HEAT","AZ",0,0,39,0,0,39
"3840",7,"HEAT","CA",492402000,170000,79,87,492572000,166
"3841",7,"HEAT","CT",0,0,1,0,0,1
"3842",7,"HEAT","DC",0,0,19,290,0,309
"3843",7,"HEAT","DE",0,0,6,28,0,34
"3844",7,"HEAT","FL",0,0,2,0,0,2
"3845",7,"HEAT","GA",0,0,6,0,0,6
"3846",7,"HEAT","IA",0,6492200,4,22,6492200,26
"3847",7,"HEAT","IL",260000,55000,828,342,315000,1170
"3848",7,"HEAT","IN",0,1e+06,14,84,1e+06,98
"3849",7,"HEAT","KS",0,108000,13,3,108000,16
"3850",7,"HEAT","KY",0,0,2,78,0,80
"3851",7,"HEAT","LA",0,20000,22,1,20000,23
"3852",7,"HEAT","MA",0,0,2,0,0,2
"3853",7,"HEAT","MD",4700000,30000,64,482,4730000,546
"3854",7,"HEAT","MI",0,0,20,102,0,122
"3855",7,"HEAT","MN",0,2127500,4,0,2127500,4
"3856",7,"HEAT","MO",425000,145000,162,2761,570000,2923
"3857",7,"HEAT","MS",76500,0,16,5,76500,21
"3858",7,"HEAT","NC",0,0,6,15,0,21
"3859",7,"HEAT","NE",150000,6592000,7,0,6742000,7
"3860",7,"HEAT","NJ",0,0,52,196,0,248
"3861",7,"HEAT","NM",0,0,1,0,0,1
"3862",7,"HEAT","NV",0,0,36,0,0,36
"3863",7,"HEAT","NY",0,0,54,0,0,54
"3864",7,"HEAT","OH",0,6e+05,13,37,6e+05,50
"3865",7,"HEAT","OK",0,0,58,115,0,173
"3866",7,"HEAT","OR",0,0,1,0,0,1
"3867",7,"HEAT","PA",0,0,337,308,0,645
"3868",7,"HEAT","SC",0,0,17,15,0,32
"3869",7,"HEAT","SD",0,1e+05,1,1,1e+05,2
"3870",7,"HEAT","TN",0,0,4,0,0,4
"3871",7,"HEAT","TX",0,0,132,426,0,558
"3872",7,"HEAT","UT",0,0,1,0,0,1
"3873",7,"HEAT","VA",6e+05,0,4,180,6e+05,184
"3874",7,"HEAT","WA",0,0,3,0,0,3
"3875",7,"HEAT","WI",0,37000,78,58,37000,136
"3876",7,"HEAT","WV",0,0,0,3,0,3
"3877",7,"HEAVY RAIN","AL",5e+06,50005000,2,0,55005000,2
"3878",7,"HEAVY RAIN","AR",0,1200000,0,0,1200000,0
"3879",7,"HEAVY RAIN","AZ",0,565000,0,0,565000,0
"3880",7,"HEAVY RAIN","CA",0,205000,0,1,205000,1
"3881",7,"HEAVY RAIN","CO",0,477000,0,0,477000,0
"3882",7,"HEAVY RAIN","CT",0,7500,0,0,7500,0
"3883",7,"HEAVY RAIN","FL",0,20300000,0,0,20300000,0
"3884",7,"HEAVY RAIN","GA",0,1145000,0,4,1145000,4
"3885",7,"HEAVY RAIN","IA",0,232000,0,0,232000,0
"3886",7,"HEAVY RAIN","ID",0,510000,0,0,510000,0
"3887",7,"HEAVY RAIN","IL",0,384000,0,0,384000,0
"3888",7,"HEAVY RAIN","IN",0,142000,0,0,142000,0
"3889",7,"HEAVY RAIN","KS",2e+05,75000,0,0,275000,0
"3890",7,"HEAVY RAIN","KY",0,12000,0,0,12000,0
"3891",7,"HEAVY RAIN","MD",0,5000,2,32,5000,34
"3892",7,"HEAVY RAIN","ME",0,5000,0,0,5000,0
"3893",7,"HEAVY RAIN","MO",0,8000,0,0,8000,0
"3894",7,"HEAVY RAIN","MS",0,130000,0,1,130000,1
"3895",7,"HEAVY RAIN","NC",0,4231000,0,3,4231000,3
"3896",7,"HEAVY RAIN","ND",5e+07,520000,1,0,50520000,1
"3897",7,"HEAVY RAIN","NE",733000,70000,0,0,803000,0
"3898",7,"HEAVY RAIN","NM",0,104000,1,5,104000,6
"3899",7,"HEAVY RAIN","NV",0,11200000,0,0,11200000,0
"3900",7,"HEAVY RAIN","NY",0,33000,0,4,33000,4
"3901",7,"HEAVY RAIN","OH",0,95000,0,0,95000,0
"3902",7,"HEAVY RAIN","PA",0,1000,0,0,1000,0
"3903",7,"HEAVY RAIN","PR",0,15000,0,0,15000,0
"3904",7,"HEAVY RAIN","SC",0,11000,0,0,11000,0
"3905",7,"HEAVY RAIN","SD",5e+06,5205000,0,0,10205000,0
"3906",7,"HEAVY RAIN","TN",0,150000,0,0,150000,0
"3907",7,"HEAVY RAIN","TX",3600000,561000,0,0,4161000,0
"3908",7,"HEAVY RAIN","UT",37000,215900,0,0,252900,0
"3909",7,"HEAVY RAIN","VA",0,2000,0,0,2000,0
"3910",7,"HEAVY RAIN","WA",640000,6000,0,0,646000,0
"3911",7,"HEAVY RAIN","WI",3000,292500,0,0,295500,0
"3912",7,"HEAVY RAIN","WV",0,41000,1,0,41000,1
"3913",7,"HIGH SURF","AK",0,7005000,0,0,7005000,0
"3914",7,"HIGH SURF","CA",0,70000,8,6,70000,14
"3915",7,"HIGH SURF","DE",0,0,0,55,0,55
"3916",7,"HIGH SURF","GU",0,0,1,1,0,2
"3917",7,"HIGH SURF","HI",0,500,0,2,500,2
"3918",7,"HIGH SURF","PR",0,0,1,0,0,1
"3919",7,"HIGH SURF","TN",0,1e+06,0,0,1e+06,0
"3920",7,"HIGH WIND","AL",0,595000,0,0,595000,0
"3921",7,"HIGH WIND","AR",0,10000,0,0,10000,0
"3922",7,"HIGH WIND","AS",50000,0,0,0,50000,0
"3923",7,"HIGH WIND","AZ",0,10000,0,0,10000,0
"3924",7,"HIGH WIND","CA",10000,12000,1,0,22000,1
"3925",7,"HIGH WIND","CO",5000,24000,0,1,29000,1
"3926",7,"HIGH WIND","FL",0,60000,1,1,60000,2
"3927",7,"HIGH WIND","GA",0,50,0,0,50,0
"3928",7,"HIGH WIND","GU",0,10000,0,0,10000,0
"3929",7,"HIGH WIND","IA",0,41000,0,0,41000,0
"3930",7,"HIGH WIND","ID",0,822000,0,3,822000,3
"3931",7,"HIGH WIND","IN",0,7000,0,0,7000,0
"3932",7,"HIGH WIND","KS",0,125000,0,2,125000,2
"3933",7,"HIGH WIND","MD",0,62000,0,0,62000,0
"3934",7,"HIGH WIND","MI",0,26000,0,0,26000,0
"3935",7,"HIGH WIND","MN",0,71120,0,0,71120,0
"3936",7,"HIGH WIND","MS",0,32000,0,0,32000,0
"3937",7,"HIGH WIND","MT",0,85000,0,0,85000,0
"3938",7,"HIGH WIND","NC",1.7e+07,493000,1,10,17493000,11
"3939",7,"HIGH WIND","ND",0,3045000,1,11,3045000,12
"3940",7,"HIGH WIND","NE",20000,1310000,1,0,1330000,1
"3941",7,"HIGH WIND","NJ",0,20000,0,0,20000,0
"3942",7,"HIGH WIND","NM",0,117500,0,6,117500,6
"3943",7,"HIGH WIND","NV",0,30000,0,0,30000,0
"3944",7,"HIGH WIND","NY",0,72000,0,0,72000,0
"3945",7,"HIGH WIND","OH",0,31000,0,4,31000,4
"3946",7,"HIGH WIND","OR",0,12000,0,0,12000,0
"3947",7,"HIGH WIND","PA",0,44000,0,0,44000,0
"3948",7,"HIGH WIND","SD",0,159220,0,5,159220,5
"3949",7,"HIGH WIND","TX",0,90000,0,0,90000,0
"3950",7,"HIGH WIND","UT",1000,84000,1,0,85000,1
"3951",7,"HIGH WIND","VT",0,415000,0,0,415000,0
"3952",7,"HIGH WIND","WA",0,114000,0,0,114000,0
"3953",7,"HIGH WIND","WV",0,3000,0,2,3000,2
"3954",7,"HIGH WIND","WY",9900,419900,0,0,429800,0
"3955",7,"HURRICANE/TYPHOON","AL",2600000,1.82e+08,1,0,184600000,1
"3956",7,"HURRICANE/TYPHOON","FL",3e+05,1569150000,4,0,1569450000,4
"3957",7,"HURRICANE/TYPHOON","GA",0,7700000,0,0,7700000,0
"3958",7,"HURRICANE/TYPHOON","GU",0,5e+05,0,0,5e+05,0
"3959",7,"HURRICANE/TYPHOON","LA",0,52500000,0,0,52500000,0
"3960",7,"HURRICANE/TYPHOON","MD",15000,1e+05,0,0,115000,0
"3961",7,"HURRICANE/TYPHOON","MS",2150000,2550000,0,0,4700000,0
"3962",7,"HURRICANE/TYPHOON","NC",144530000,167450000,1,10,311980000,11
"3963",7,"HURRICANE/TYPHOON","PR",6e+06,7910000,1,1,13910000,2
"3964",7,"HURRICANE/TYPHOON","SC",5e+05,1580000,0,0,2080000,0
"3965",7,"HURRICANE/TYPHOON","TX",0,10880000,0,2,10880000,2
"3966",7,"LIGHTNING","AL",5000,4814100,10,37,4819100,47
"3967",7,"LIGHTNING","AR",0,12387000,2,17,12387000,19
"3968",7,"LIGHTNING","AZ",0,6345750,5,22,6345750,27
"3969",7,"LIGHTNING","CA",0,1225500,3,15,1225500,18
"3970",7,"LIGHTNING","CO",12000,7452250,19,77,7464250,96
"3971",7,"LIGHTNING","CT",0,309500,0,7,309500,7
"3972",7,"LIGHTNING","DE",0,2525500,0,2,2525500,2
"3973",7,"LIGHTNING","FL",40000,38570950,33,275,38610950,308
"3974",7,"LIGHTNING","GA",0,26155500,9,43,26155500,52
"3975",7,"LIGHTNING","GU",0,50000,0,0,50000,0
"3976",7,"LIGHTNING","IA",10500,2072550,0,4,2083050,4
"3977",7,"LIGHTNING","ID",0,651000,5,17,651000,22
"3978",7,"LIGHTNING","IL",0,8318000,3,14,8318000,17
"3979",7,"LIGHTNING","IN",0,4372700,6,14,4372700,20
"3980",7,"LIGHTNING","KS",300,2550900,0,6,2551200,6
"3981",7,"LIGHTNING","KY",0,1156500,1,7,1156500,8
"3982",7,"LIGHTNING","LA",10000,1865500,9,15,1875500,24
"3983",7,"LIGHTNING","MA",0,3910110.2,2,67,3910110.2,69
"3984",7,"LIGHTNING","MD",5000,2972000,4,18,2977000,22
"3985",7,"LIGHTNING","ME",0,5331000,4,34,5331000,38
"3986",7,"LIGHTNING","MI",0,8648000,9,79,8648000,88
"3987",7,"LIGHTNING","MN",0,5592500,2,34,5592500,36
"3988",7,"LIGHTNING","MO",0,721000,2,14,721000,16
"3989",7,"LIGHTNING","MS",2000,1284000,5,12,1286000,17
"3990",7,"LIGHTNING","MT",0,168000,3,10,168000,13
"3991",7,"LIGHTNING","NC",50000,18468500,11,129,18518500,140
"3992",7,"LIGHTNING","ND",0,792500,1,2,792500,3
"3993",7,"LIGHTNING","NE",0,3149000,3,3,3149000,6
"3994",7,"LIGHTNING","NH",0,6203000,0,30,6203000,30
"3995",7,"LIGHTNING","NJ",1000,4766650,6,47,4767650,53
"3996",7,"LIGHTNING","NM",0,152000,1,21,152000,22
"3997",7,"LIGHTNING","NV",0,1828000,1,7,1828000,8
"3998",7,"LIGHTNING","NY",0,3976500,5,84,3976500,89
"3999",7,"LIGHTNING","OH",1050000,8660000,4,31,9710000,35
"4000",7,"LIGHTNING","OK",0,3727200,4,45,3727200,49
"4001",7,"LIGHTNING","OR",0,263000,0,0,263000,0
"4002",7,"LIGHTNING","PA",0,7824000,8,91,7824000,99
"4003",7,"LIGHTNING","PR",0,8000,0,0,8000,0
"4004",7,"LIGHTNING","RI",0,135000,0,4,135000,4
"4005",7,"LIGHTNING","SC",0,6274000,6,38,6274000,44
"4006",7,"LIGHTNING","SD",500,289000,1,7,289500,8
"4007",7,"LIGHTNING","TN",0,4963800,6,40,4963800,46
"4008",7,"LIGHTNING","TX",0,10125500,10,56,10125500,66
"4009",7,"LIGHTNING","UT",0,203500,8,10,203500,18
"4010",7,"LIGHTNING","VA",3000,3659773,6,20,3662773,26
"4011",7,"LIGHTNING","VT",0,3187000,2,3,3187000,5
"4012",7,"LIGHTNING","WA",0,428000,0,4,428000,4
"4013",7,"LIGHTNING","WI",160000,8056700,4,47,8216700,51
"4014",7,"LIGHTNING","WV",0,444000,1,3,444000,4
"4015",7,"LIGHTNING","WY",9000,427000,4,27,436000,31
"4016",7,"MARINE STRONG WIND","AM",0,0,1,0,0,1
"4017",7,"MARINE STRONG WIND","AN",0,0,1,7,0,8
"4018",7,"MARINE THUNDERSTORM WIND","AM",0,0,0,5,0,5
"4019",7,"MARINE THUNDERSTORM WIND","AN",0,61000,0,3,61000,3
"4020",7,"MARINE THUNDERSTORM WIND","GM",0,85000,0,0,85000,0
"4021",7,"MARINE THUNDERSTORM WIND","LM",0,344000,2,1,344000,3
"4022",7,"MARINE THUNDERSTORM WIND","LO",0,30000,0,0,30000,0
"4023",7,"OTHER EVENT NON IDENTIFIED","AZ",0,5000,0,0,5000,0
"4024",7,"OTHER EVENT NON IDENTIFIED","NM",0,0,0,4,0,4
"4025",7,"RIP CURRENT","AL",0,0,4,3,0,7
"4026",7,"RIP CURRENT","CA",0,0,5,7,0,12
"4027",7,"RIP CURRENT","DE",0,0,0,27,0,27
"4028",7,"RIP CURRENT","FL",0,0,40,68,0,108
"4029",7,"RIP CURRENT","GA",0,1000,0,0,1000,0
"4030",7,"RIP CURRENT","GU",0,40000,0,3,40000,3
"4031",7,"RIP CURRENT","IL",0,0,1,0,0,1
"4032",7,"RIP CURRENT","IN",0,0,3,0,0,3
"4033",7,"RIP CURRENT","MA",0,0,1,0,0,1
"4034",7,"RIP CURRENT","MD",0,0,1,1,0,2
"4035",7,"RIP CURRENT","MI",0,0,6,4,0,10
"4036",7,"RIP CURRENT","MN",0,0,0,2,0,2
"4037",7,"RIP CURRENT","NC",0,0,8,6,0,14
"4038",7,"RIP CURRENT","NJ",0,0,5,3,0,8
"4039",7,"RIP CURRENT","NY",0,0,6,0,0,6
"4040",7,"RIP CURRENT","OR",0,0,1,2,0,3
"4041",7,"RIP CURRENT","SC",0,0,9,3,0,12
"4042",7,"RIP CURRENT","TX",0,0,6,1,0,7
"4043",7,"RIP CURRENT","WA",0,0,1,0,0,1
"4044",7,"STORM SURGE/TIDE","FL",0,54250000,0,0,54250000,0
"4045",7,"STORM SURGE/TIDE","LA",0,2500000,0,0,2500000,0
"4046",7,"STORM SURGE/TIDE","MS",0,1e+06,0,0,1e+06,0
"4047",7,"STRONG WIND","AL",0,65000,0,3,65000,3
"4048",7,"STRONG WIND","AZ",0,2000,0,0,2000,0
"4049",7,"STRONG WIND","CA",0,14000,0,0,14000,0
"4050",7,"STRONG WIND","GA",0,275600,2,4,275600,6
"4051",7,"STRONG WIND","GU",0,10000,0,1,10000,1
"4052",7,"STRONG WIND","HI",0,500,0,0,500,0
"4053",7,"STRONG WIND","IN",0,3e+06,0,0,3e+06,0
"4054",7,"STRONG WIND","KS",0,8000,0,0,8000,0
"4055",7,"STRONG WIND","MA",0,30000,1,0,30000,1
"4056",7,"STRONG WIND","MD",0,0,0,2,0,2
"4057",7,"STRONG WIND","MN",0,0,0,1,0,1
"4058",7,"STRONG WIND","MS",0,30400,0,0,30400,0
"4059",7,"STRONG WIND","MT",0,6000,0,0,6000,0
"4060",7,"STRONG WIND","NC",0,47000,1,1,47000,2
"4061",7,"STRONG WIND","NE",0,25000,0,0,25000,0
"4062",7,"STRONG WIND","NJ",0,250,0,0,250,0
"4063",7,"STRONG WIND","NM",0,200,0,0,200,0
"4064",7,"STRONG WIND","NY",0,25000,0,2,25000,2
"4065",7,"STRONG WIND","OR",0,15000,0,0,15000,0
"4066",7,"STRONG WIND","PR",0,5000,0,0,5000,0
"4067",7,"STRONG WIND","SC",0,28000,1,0,28000,1
"4068",7,"STRONG WIND","TX",0,133000,0,10,133000,10
"4069",7,"STRONG WIND","UT",0,15000,0,0,15000,0
"4070",7,"STRONG WIND","WA",0,19000,0,1,19000,1
"4071",7,"STRONG WIND","WI",0,15000,1,0,15000,1
"4072",7,"THUNDERSTORM WIND","AK",0,18000,0,0,18000,0
"4073",7,"THUNDERSTORM WIND","AL",4000,14472750,15,44,14476750,59
"4074",7,"THUNDERSTORM WIND","AR",0,6812350,3,29,6812350,32
"4075",7,"THUNDERSTORM WIND","AZ",1e+05,242036100,2,87,242136100,89
"4076",7,"THUNDERSTORM WIND","CA",0,1473500,0,4,1473500,4
"4077",7,"THUNDERSTORM WIND","CO",60000,1699900,3,26,1759900,29
"4078",7,"THUNDERSTORM WIND","CT",0,1760750,1,13,1760750,14
"4079",7,"THUNDERSTORM WIND","DC",0,367500,0,0,367500,0
"4080",7,"THUNDERSTORM WIND","DE",0,235000,1,4,235000,5
"4081",7,"THUNDERSTORM WIND","FL",25000,10495150,2,36,10520150,38
"4082",7,"THUNDERSTORM WIND","GA",20000,32210650,8,66,32230650,74
"4083",7,"THUNDERSTORM WIND","IA",45281450,63878150,3,33,109159600,36
"4084",7,"THUNDERSTORM WIND","ID",14000,1770000,2,17,1784000,19
"4085",7,"THUNDERSTORM WIND","IL",29126000,119119900,4,91,148245900,95
"4086",7,"THUNDERSTORM WIND","IN",70000,14236000,4,67,14306000,71
"4087",7,"THUNDERSTORM WIND","KS",13363000,119143550,4,85,132506550,89
"4088",7,"THUNDERSTORM WIND","KY",551000,9554700,2,51,10105700,53
"4089",7,"THUNDERSTORM WIND","LA",0,5875500,2,16,5875500,18
"4090",7,"THUNDERSTORM WIND","MA",1250000,6559000,3,11,7809000,14
"4091",7,"THUNDERSTORM WIND","MD",77000,12190000,0,22,12267000,22
"4092",7,"THUNDERSTORM WIND","ME",0,363000,0,10,363000,10
"4093",7,"THUNDERSTORM WIND","MI",604000,132444250,18,48,133048250,66
"4094",7,"THUNDERSTORM WIND","MN",37623000,73225050,1,30,110848050,31
"4095",7,"THUNDERSTORM WIND","MO",75000,8805700,2,112,8880700,114
"4096",7,"THUNDERSTORM WIND","MS",0,13610550,4,18,13610550,22
"4097",7,"THUNDERSTORM WIND","MT",4051000,13273400,4,12,17324400,16
"4098",7,"THUNDERSTORM WIND","NC",391000,12686500,4,48,13077500,52
"4099",7,"THUNDERSTORM WIND","ND",187473000,122494200,1,2,309967200,3
"4100",7,"THUNDERSTORM WIND","NE",104985000,29021400,1,34,134006400,35
"4101",7,"THUNDERSTORM WIND","NH",0,5571500,2,6,5571500,8
"4102",7,"THUNDERSTORM WIND","NJ",1e+05,7642500,2,75,7742500,77
"4103",7,"THUNDERSTORM WIND","NM",20000,1373200,1,3,1393200,4
"4104",7,"THUNDERSTORM WIND","NV",0,52914000,0,14,52914000,14
"4105",7,"THUNDERSTORM WIND","NY",412000,215173520,12,101,215585520,113
"4106",7,"THUNDERSTORM WIND","OH",2390000,44209270,12,73,46599270,85
"4107",7,"THUNDERSTORM WIND","OK",0,67579480,3,20,67579480,23
"4108",7,"THUNDERSTORM WIND","OR",0,793000,0,1,793000,1
"4109",7,"THUNDERSTORM WIND","PA",5000,24410000,6,92,24415000,98
"4110",7,"THUNDERSTORM WIND","PR",5000,15763000,0,8,15768000,8
"4111",7,"THUNDERSTORM WIND","RI",0,151000,0,0,151000,0
"4112",7,"THUNDERSTORM WIND","SC",50000,8267700,1,36,8317700,37
"4113",7,"THUNDERSTORM WIND","SD",6066000,22787000,0,36,28853000,36
"4114",7,"THUNDERSTORM WIND","TN",2227000,54650005,2,26,56877005,28
"4115",7,"THUNDERSTORM WIND","TX",3677500,29355150,4,45,33032650,49
"4116",7,"THUNDERSTORM WIND","UT",29300,717800,0,11,747100,11
"4117",7,"THUNDERSTORM WIND","VA",1035000,17400100,2,35,18435100,37
"4118",7,"THUNDERSTORM WIND","VI",0,300,0,0,300,0
"4119",7,"THUNDERSTORM WIND","VT",210000,5414000,3,18,5624000,21
"4120",7,"THUNDERSTORM WIND","WA",3740000,1003000,0,0,4743000,0
"4121",7,"THUNDERSTORM WIND","WI",11227700,30774850,6,76,42002550,82
"4122",7,"THUNDERSTORM WIND","WV",55000,5152300,3,20,5207300,23
"4123",7,"THUNDERSTORM WIND","WY",4000,824000,0,1,828000,1
"4124",7,"TORNADO","AL",0,2552750,0,9,2552750,9
"4125",7,"TORNADO","AR",0,9314280,0,29,9314280,29
"4126",7,"TORNADO","AZ",0,3558030,0,10,3558030,10
"4127",7,"TORNADO","CA",0,86560,0,1,86560,1
"4128",7,"TORNADO","CO",6510000,2785040,0,14,9295040,14
"4129",7,"TORNADO","CT",0,330219000,0,119,330219000,119
"4130",7,"TORNADO","DE",0,1657500,2,13,1657500,15
"4131",7,"TORNADO","FL",0,18735790,2,43,18735790,45
"4132",7,"TORNADO","GA",500,76532030,1,19,76532530,20
"4133",7,"TORNADO","IA",1498150,635868400,0,106,637366550,106
"4134",7,"TORNADO","ID",0,240530,0,1,240530,1
"4135",7,"TORNADO","IL",37200,42386320,2,89,42423520,91
"4136",7,"TORNADO","IN",27000,65679280,2,99,65706280,101
"4137",7,"TORNADO","KS",70000,8823870,1,36,8893870,37
"4138",7,"TORNADO","KY",12000,11685780,0,23,11697780,23
"4139",7,"TORNADO","LA",0,1120030,0,7,1120030,7
"4140",7,"TORNADO","MA",0,8121030,0,13,8121030,13
"4141",7,"TORNADO","MD",195000,8172250,0,14,8367250,14
"4142",7,"TORNADO","ME",0,3787750,0,6,3787750,6
"4143",7,"TORNADO","MI",366000,174566900,3,236,174932900,239
"4144",7,"TORNADO","MN",6400000,154798140,14,194,161198140,208
"4145",7,"TORNADO","MO",2500,3716640,0,20,3719140,20
"4146",7,"TORNADO","MS",0,9788750,0,1,9788750,1
"4147",7,"TORNADO","MT",80000,41489280,4,14,41569280,18
"4148",7,"TORNADO","NC",415000,8631000,4,17,9046000,21
"4149",7,"TORNADO","ND",9055000,54987910,9,103,64042910,112
"4150",7,"TORNADO","NE",2302000,102924910,1,64,105226910,65
"4151",7,"TORNADO","NH",0,2397500,1,16,2397500,17
"4152",7,"TORNADO","NJ",2e+05,44147500,0,20,44347500,20
"4153",7,"TORNADO","NM",0,2409090,0,6,2409090,6
"4154",7,"TORNADO","NV",7000,25000,0,1,32000,1
"4155",7,"TORNADO","NY",35000,179437000,0,62,179472000,62
"4156",7,"TORNADO","OH",76000,47868250,0,165,47944250,165
"4157",7,"TORNADO","OK",0,2295490,1,12,2295490,13
"4158",7,"TORNADO","OR",0,2500,0,0,2500,0
"4159",7,"TORNADO","PA",21000,412639750,6,146,412660750,152
"4160",7,"TORNADO","PR",0,15000,0,0,15000,0
"4161",7,"TORNADO","RI",0,45000,0,0,45000,0
"4162",7,"TORNADO","SC",26000,11568500,1,50,11594500,51
"4163",7,"TORNADO","SD",15500,36105010,5,45,36120510,50
"4164",7,"TORNADO","TN",3000,1996500,0,22,1999500,22
"4165",7,"TORNADO","TX",0,11317420,1,50,11317420,51
"4166",7,"TORNADO","UT",0,42500,0,0,42500,0
"4167",7,"TORNADO","VA",20000,7905780,0,24,7925780,24
"4168",7,"TORNADO","VT",25000,682500,0,0,707500,0
"4169",7,"TORNADO","WA",0,85000,0,0,85000,0
"4170",7,"TORNADO","WI",6594800,126083740,6,135,132678540,141
"4171",7,"TORNADO","WV",16000,2580090,0,7,2596090,7
"4172",7,"TORNADO","WY",0,29523140,1,51,29523140,52
"4173",7,"TROPICAL DEPRESSION","MS",0,35000,0,0,35000,0
"4174",7,"TROPICAL DEPRESSION","TN",0,5000,0,0,5000,0
"4175",7,"TROPICAL STORM","AL",0,5715000,0,3,5715000,3
"4176",7,"TROPICAL STORM","FL",0,5334000,0,0,5334000,0
"4177",7,"TROPICAL STORM","GU",125000,875000,0,0,1e+06,0
"4178",7,"TROPICAL STORM","MS",0,9300000,0,0,9300000,0
"4179",7,"TROPICAL STORM","NJ",0,0,1,2,0,3
"4180",7,"TROPICAL STORM","TX",3190000,4030000,1,0,7220000,1
"4181",7,"VOLCANIC ASH","PR",0,3e+05,0,0,3e+05,0
"4182",7,"VOLCANIC ASH","VI",0,2e+05,0,0,2e+05,0
"4183",7,"WATERSPOUT","AL",0,1000,0,0,1000,0
"4184",7,"WATERSPOUT","FL",0,6e+05,0,0,6e+05,0
"4185",7,"WATERSPOUT","MI",0,2e+05,0,0,2e+05,0
"4186",7,"WATERSPOUT","NC",0,60000,0,1,60000,1
"4187",7,"WILDFIRE","AK",0,4e+05,0,0,4e+05,0
"4188",7,"WILDFIRE","AR",10000,150000,0,0,160000,0
"4189",7,"WILDFIRE","AZ",0,81050000,0,13,81050000,13
"4190",7,"WILDFIRE","CA",1.6e+07,64962000,3,116,80962000,119
"4191",7,"WILDFIRE","CO",0,38020000,0,2,38020000,2
"4192",7,"WILDFIRE","FL",0,380030000,0,79,380030000,79
"4193",7,"WILDFIRE","HI",0,230000,0,0,230000,0
"4194",7,"WILDFIRE","ID",120000,1140000,2,0,1260000,2
"4195",7,"WILDFIRE","KS",0,10000,0,0,10000,0
"4196",7,"WILDFIRE","MI",0,50000,0,0,50000,0
"4197",7,"WILDFIRE","MN",0,0,0,2,0,2
"4198",7,"WILDFIRE","MT",1e+06,6235500,0,8,7235500,8
"4199",7,"WILDFIRE","NE",0,1500000,0,0,1500000,0
"4200",7,"WILDFIRE","NJ",0,0,0,5,0,5
"4201",7,"WILDFIRE","NM",0,67012000,0,0,67012000,0
"4202",7,"WILDFIRE","OK",0,15000,0,3,15000,3
"4203",7,"WILDFIRE","OR",106000,5545000,0,0,5651000,0
"4204",7,"WILDFIRE","TX",0,1763000,0,3,1763000,3
"4205",7,"WILDFIRE","UT",40000,270000,4,0,310000,4
"4206",7,"WILDFIRE","VA",6700,92000,0,0,98700,0
"4207",7,"WILDFIRE","WA",575000,6999500,4,7,7574500,11
"4208",7,"WILDFIRE","WY",0,70000,0,0,70000,0
"4209",8,"COASTAL FLOOD","AK",0,0,2,0,0,2
"4210",8,"DEBRIS FLOW","AL",0,9000,0,0,9000,0
"4211",8,"DEBRIS FLOW","CO",0,10500,0,0,10500,0
"4212",8,"DEBRIS FLOW","UT",0,500,0,0,500,0
"4213",8,"DENSE FOG","CA",0,350000,0,1,350000,1
"4214",8,"DENSE FOG","CO",0,2e+05,0,0,2e+05,0
"4215",8,"DENSE FOG","WI",0,0,1,0,0,1
"4216",8,"DROUGHT","AR",5e+05,0,0,0,5e+05,0
"4217",8,"DROUGHT","DC",5000,0,0,0,5000,0
"4218",8,"DROUGHT","IA",1584060000,645150000,0,0,2229210000,0
"4219",8,"DROUGHT","IL",48460000,0,0,0,48460000,0
"4220",8,"DROUGHT","KS",3e+07,0,0,0,3e+07,0
"4221",8,"DROUGHT","LA",315880000,0,0,0,315880000,0
"4222",8,"DROUGHT","MD",3e+07,0,0,0,3e+07,0
"4223",8,"DROUGHT","MO",21680000,1e+05,0,0,21780000,0
"4224",8,"DROUGHT","MS",7e+05,0,0,0,7e+05,0
"4225",8,"DROUGHT","NM",2400000,0,0,0,2400000,0
"4226",8,"DROUGHT","NY",50200000,0,0,0,50200000,0
"4227",8,"DROUGHT","OK",436340000,154000,0,4,436494000,4
"4228",8,"DROUGHT","OR",22600000,0,0,0,22600000,0
"4229",8,"DROUGHT","PA",1400000,0,0,0,1400000,0
"4230",8,"DROUGHT","TX",973245000,56668000,0,0,1029913000,0
"4231",8,"DROUGHT","VA",42160000,0,0,0,42160000,0
"4232",8,"DROUGHT","WI",4440000,0,0,0,4440000,0
"4233",8,"DROUGHT","WV",7e+06,0,0,0,7e+06,0
"4234",8,"DUST DEVIL","MT",0,0,0,3,0,3
"4235",8,"DUST DEVIL","NM",0,0,0,1,0,1
"4236",8,"DUST DEVIL","NV",0,15000,0,0,15000,0
"4237",8,"DUST DEVIL","NY",0,1200,0,4,1200,4
"4238",8,"DUST DEVIL","OK",0,5500,0,0,5500,0
"4239",8,"DUST DEVIL","WI",0,200,0,0,200,0
"4240",8,"DUST STORM","AZ",0,262000,0,0,262000,0
"4241",8,"DUST STORM","CA",0,1e+05,0,0,1e+05,0
"4242",8,"DUST STORM","ID",0,0,0,3,0,3
"4243",8,"DUST STORM","NV",0,80000,0,15,80000,15
"4244",8,"FLASH FLOOD","AK",0,30000,0,0,30000,0
"4245",8,"FLASH FLOOD","AL",0,917000,0,4,917000,4
"4246",8,"FLASH FLOOD","AR",1500000,1601000,0,0,3101000,0
"4247",8,"FLASH FLOOD","AZ",5000,25714000,40,122,25719000,162
"4248",8,"FLASH FLOOD","CA",0,31617500,7,24,31617500,31
"4249",8,"FLASH FLOOD","CO",73000,133746207.5,2,3,133819207.5,5
"4250",8,"FLASH FLOOD","CT",0,11500000,0,0,11500000,0
"4251",8,"FLASH FLOOD","DC",0,6e+06,0,2,6e+06,2
"4252",8,"FLASH FLOOD","DE",0,1100000,4,0,1100000,4
"4253",8,"FLASH FLOOD","FL",0,90075000,1,0,90075000,1
"4254",8,"FLASH FLOOD","GA",0,12578500,0,0,12578500,0
"4255",8,"FLASH FLOOD","GU",0,10000,0,0,10000,0
"4256",8,"FLASH FLOOD","HI",50000,5050000,0,0,5100000,0
"4257",8,"FLASH FLOOD","IA",8600000,60664000,1,5,69264000,6
"4258",8,"FLASH FLOOD","ID",0,5014000,0,0,5014000,0
"4259",8,"FLASH FLOOD","IL",50,45288950,3,0,45289000,3
"4260",8,"FLASH FLOOD","IN",354500,9505000,1,0,9859500,1
"4261",8,"FLASH FLOOD","KS",695000,4426100,7,0,5121100,7
"4262",8,"FLASH FLOOD","KY",50000,66372000,5,2,66422000,7
"4263",8,"FLASH FLOOD","LA",1512000,1889000,0,0,3401000,0
"4264",8,"FLASH FLOOD","MA",0,1292000,0,0,1292000,0
"4265",8,"FLASH FLOOD","MD",10000,4001000,0,0,4011000,0
"4266",8,"FLASH FLOOD","ME",0,2893000,0,0,2893000,0
"4267",8,"FLASH FLOOD","MI",1e+06,6122000,0,0,7122000,0
"4268",8,"FLASH FLOOD","MN",3907000,166090500,7,33,169997500,40
"4269",8,"FLASH FLOOD","MO",24000,71470700,1,1,71494700,2
"4270",8,"FLASH FLOOD","MS",850000,12564000,1,0,13414000,1
"4271",8,"FLASH FLOOD","MT",635000,831000,0,0,1466000,0
"4272",8,"FLASH FLOOD","NC",2200000,31721500,7,1,33921500,8
"4273",8,"FLASH FLOOD","ND",705000,3162500,0,0,3867500,0
"4274",8,"FLASH FLOOD","NE",3481000,21990000,1,2,25471000,3
"4275",8,"FLASH FLOOD","NH",0,21570000,1,3,21570000,4
"4276",8,"FLASH FLOOD","NJ",750000,113700000,0,1,114450000,1
"4277",8,"FLASH FLOOD","NM",4751000,27402000,3,0,32153000,3
"4278",8,"FLASH FLOOD","NV",10000,16614000,1,6,16624000,7
"4279",8,"FLASH FLOOD","NY",2050000,277898000,13,1,279948000,14
"4280",8,"FLASH FLOOD","OH",16870000,305526040,3,6,322396040,9
"4281",8,"FLASH FLOOD","OK",0,6353500,6,2,6353500,8
"4282",8,"FLASH FLOOD","OR",0,7000,0,0,7000,0
"4283",8,"FLASH FLOOD","PA",0,140918002.2,5,8,140918002.2,13
"4284",8,"FLASH FLOOD","PR",0,2181000,2,1,2181000,3
"4285",8,"FLASH FLOOD","RI",0,20000,0,0,20000,0
"4286",8,"FLASH FLOOD","SC",0,19764000,3,11,19764000,14
"4287",8,"FLASH FLOOD","SD",500,4425500,0,0,4426000,0
"4288",8,"FLASH FLOOD","TN",359000,35729510,0,1,36088510,1
"4289",8,"FLASH FLOOD","TX",1348000,332188000,25,205,333536000,230
"4290",8,"FLASH FLOOD","UT",158000,9391000,1,1,9549000,2
"4291",8,"FLASH FLOOD","VA",0,32978000,9,0,32978000,9
"4292",8,"FLASH FLOOD","VT",1.4e+07,273461000,3,0,287461000,3
"4293",8,"FLASH FLOOD","WA",0,459000,0,0,459000,0
"4294",8,"FLASH FLOOD","WI",20693000,174291300,3,8,194984300,11
"4295",8,"FLASH FLOOD","WV",5000,8066400,0,1,8071400,1
"4296",8,"FLASH FLOOD","WY",50,1769400,1,0,1769450,1
"4297",8,"FLOOD","AK",0,21190500,0,0,21190500,0
"4298",8,"FLOOD","AR",105000,1000,0,0,106000,0
"4299",8,"FLOOD","AZ",0,603000,0,1,603000,1
"4300",8,"FLOOD","CA",0,10000,0,0,10000,0
"4301",8,"FLOOD","CO",1e+05,26570000,3,1,26670000,4
"4302",8,"FLOOD","CT",0,8015000,1,0,8015000,1
"4303",8,"FLOOD","FL",2.5e+07,72441200,0,0,97441200,0
"4304",8,"FLOOD","GA",0,442600,0,0,442600,0
"4305",8,"FLOOD","IA",24657000,119352000,0,0,144009000,0
"4306",8,"FLOOD","ID",0,15000,0,0,15000,0
"4307",8,"FLOOD","IL",5000507000,5011825000,3,0,10012332000,3
"4308",8,"FLOOD","IN",2721000,6343000,0,0,9064000,0
"4309",8,"FLOOD","KS",5200000,540800,0,0,5740800,0
"4310",8,"FLOOD","KY",0,4885000,1,0,4885000,1
"4311",8,"FLOOD","LA",0,122000,0,0,122000,0
"4312",8,"FLOOD","MA",0,24524000,0,0,24524000,0
"4313",8,"FLOOD","MD",0,5e+06,0,0,5e+06,0
"4314",8,"FLOOD","ME",0,1730000,0,0,1730000,0
"4315",8,"FLOOD","MI",15000,5770000,0,0,5785000,0
"4316",8,"FLOOD","MN",2270000,15235000,0,0,17505000,0
"4317",8,"FLOOD","MO",13000,5402000,1,0,5415000,1
"4318",8,"FLOOD","MS",0,3000,0,0,3000,0
"4319",8,"FLOOD","MT",5e+05,5e+06,0,0,5500000,0
"4320",8,"FLOOD","NC",0,5333000,0,0,5333000,0
"4321",8,"FLOOD","ND",5235000,55650000,1,0,60885000,1
"4322",8,"FLOOD","NE",8015000,9277000,0,0,17292000,0
"4323",8,"FLOOD","NH",0,10816000,0,0,10816000,0
"4324",8,"FLOOD","NJ",0,1701100000,11,0,1701100000,11
"4325",8,"FLOOD","NM",0,104000,0,0,104000,0
"4326",8,"FLOOD","NY",1500000,6681000,3,1,8181000,4
"4327",8,"FLOOD","OH",1413000,21061000,0,1,22474000,1
"4328",8,"FLOOD","OK",0,75000,0,0,75000,0
"4329",8,"FLOOD","PA",75000,19815500,2,0,19890500,2
"4330",8,"FLOOD","PR",0,37500,0,0,37500,0
"4331",8,"FLOOD","RI",0,25000,0,0,25000,0
"4332",8,"FLOOD","SC",1e+07,7830000,1,0,17830000,1
"4333",8,"FLOOD","SD",50500,530000,0,0,580500,0
"4334",8,"FLOOD","TN",3500000,61173000,0,0,64673000,0
"4335",8,"FLOOD","TX",2040000,8642000,3,80,10682000,83
"4336",8,"FLOOD","UT",32000,805000,0,0,837000,0
"4337",8,"FLOOD","VA",0,30000,0,0,30000,0
"4338",8,"FLOOD","VT",11950000,1060447000,1,1,1072397000,2
"4339",8,"FLOOD","WI",981000,8694500,0,1,9675500,1
"4340",8,"FLOOD","WV",0,107000,0,0,107000,0
"4341",8,"FLOOD","WY",0,81000,0,0,81000,0
"4342",8,"FUNNEL CLOUD","FL",0,500,0,0,500,0
"4343",8,"FUNNEL CLOUD","ID",0,2000,0,0,2000,0
"4344",8,"HAIL","AL",18000,231000,0,0,249000,0
"4345",8,"HAIL","AN",0,4000,0,0,4000,0
"4346",8,"HAIL","AR",1e+05,578950,0,0,678950,0
"4347",8,"HAIL","AZ",79000,255900,0,1,334900,1
"4348",8,"HAIL","CA",10000,40000,0,2,50000,2
"4349",8,"HAIL","CO",1950000,55175305,0,17,57125305,17
"4350",8,"HAIL","CT",0,7000,0,0,7000,0
"4351",8,"HAIL","DE",0,50,0,0,50,0
"4352",8,"HAIL","FL",0,170500,0,3,170500,3
"4353",8,"HAIL","GA",500,1655750,0,0,1656250,0
"4354",8,"HAIL","IA",179612500,30549500,0,31,210162000,31
"4355",8,"HAIL","ID",90000,1048000,0,0,1138000,0
"4356",8,"HAIL","IL",5800000,2961500,0,0,8761500,0
"4357",8,"HAIL","IN",545000,1052000,0,0,1597000,0
"4358",8,"HAIL","KS",6902000,9664000,0,20,16566000,20
"4359",8,"HAIL","KY",860500,520500,0,0,1381000,0
"4360",8,"HAIL","LA",0,10500,0,0,10500,0
"4361",8,"HAIL","MA",0,151700,0,0,151700,0
"4362",8,"HAIL","MD",1000,6000,0,0,7000,0
"4363",8,"HAIL","MI",480000,835000,0,0,1315000,0
"4364",8,"HAIL","MN",8062500,171573350,0,4,179635850,4
"4365",8,"HAIL","MO",5000,103870,0,0,108870,0
"4366",8,"HAIL","MS",0,303390,0,0,303390,0
"4367",8,"HAIL","MT",1385000,2785000,0,3,4170000,3
"4368",8,"HAIL","NC",9940000,1390000,0,0,11330000,0
"4369",8,"HAIL","ND",25870000,65345000,0,12,91215000,12
"4370",8,"HAIL","NE",90050000,13729250,0,4,103779250,4
"4371",8,"HAIL","NJ",17100000,325000,0,0,17425000,0
"4372",8,"HAIL","NM",42000,6313100,1,2,6355100,3
"4373",8,"HAIL","NV",0,145000,1,0,145000,1
"4374",8,"HAIL","NY",499000,1464750,0,2,1963750,2
"4375",8,"HAIL","OH",12945000,3157000,0,1,16102000,1
"4376",8,"HAIL","OK",101000,382950,0,13,483950,13
"4377",8,"HAIL","OR",10000,1500,0,1,11500,1
"4378",8,"HAIL","PA",50,1758000,0,0,1758050,0
"4379",8,"HAIL","PR",0,7000,0,0,7000,0
"4380",8,"HAIL","SC",25000,10148000,0,1,10173000,1
"4381",8,"HAIL","SD",3573500,14408550,0,1,17982050,1
"4382",8,"HAIL","TN",35000,73260,0,0,108260,0
"4383",8,"HAIL","TX",6232000,1961500,0,0,8193500,0
"4384",8,"HAIL","UT",151450,551000,0,0,702450,0
"4385",8,"HAIL","VA",510000,40850,0,0,550850,0
"4386",8,"HAIL","VT",0,5000,0,0,5000,0
"4387",8,"HAIL","WA",270000,370000,0,0,640000,0
"4388",8,"HAIL","WI",9332000,10176200,0,0,19508200,0
"4389",8,"HAIL","WV",0,6010000,0,0,6010000,0
"4390",8,"HAIL","WY",310000,33060000,0,5,33370000,5
"4391",8,"HEAT","AL",400100000,0,6,17,400100000,23
"4392",8,"HEAT","AR",0,0,15,0,0,15
"4393",8,"HEAT","AZ",0,0,4,0,0,4
"4394",8,"HEAT","CA",0,0,14,3,0,17
"4395",8,"HEAT","DC",0,0,3,25,0,28
"4396",8,"HEAT","DE",0,0,2,8,0,10
"4397",8,"HEAT","FL",0,0,1,1,0,2
"4398",8,"HEAT","GA",0,0,4,3,0,7
"4399",8,"HEAT","IA",0,0,1,0,0,1
"4400",8,"HEAT","IL",2e+05,0,93,112,2e+05,205
"4401",8,"HEAT","IN",0,0,1,0,0,1
"4402",8,"HEAT","KS",0,0,2,14,0,16
"4403",8,"HEAT","KY",0,0,0,8,0,8
"4404",8,"HEAT","LA",0,90000,23,2,90000,25
"4405",8,"HEAT","MD",5780,0,25,55,5780,80
"4406",8,"HEAT","MI",0,0,1,415,0,416
"4407",8,"HEAT","MN",0,0,11,0,0,11
"4408",8,"HEAT","MO",4e+05,324000,44,1134,724000,1178
"4409",8,"HEAT","MS",0,0,7,0,0,7
"4410",8,"HEAT","NC",0,0,3,2,0,5
"4411",8,"HEAT","NJ",0,0,6,44,0,50
"4412",8,"HEAT","NV",0,0,16,0,0,16
"4413",8,"HEAT","NY",0,0,46,1,0,47
"4414",8,"HEAT","OH",0,5e+05,18,75,5e+05,93
"4415",8,"HEAT","OK",0,10000,20,98,10000,118
"4416",8,"HEAT","PA",50000,2e+05,151,60,250000,211
"4417",8,"HEAT","SC",0,0,19,0,0,19
"4418",8,"HEAT","TN",0,0,17,1,0,18
"4419",8,"HEAT","TX",0,2e+05,78,218,2e+05,296
"4420",8,"HEAT","VA",0,50,2,72,50,74
"4421",8,"HEAT","WI",0,0,8,0,0,8
"4422",8,"HEAT","WV",0,0,1,0,0,1
"4423",8,"HEAVY RAIN","AK",0,5000,0,0,5000,0
"4424",8,"HEAVY RAIN","AL",0,21500,0,0,21500,0
"4425",8,"HEAVY RAIN","AZ",0,242000,0,0,242000,0
"4426",8,"HEAVY RAIN","CA",0,52500,0,0,52500,0
"4427",8,"HEAVY RAIN","CO",0,370500,1,0,370500,1
"4428",8,"HEAVY RAIN","CT",0,0,2,0,0,2
"4429",8,"HEAVY RAIN","DC",0,3000,0,0,3000,0
"4430",8,"HEAVY RAIN","DE",0,0,0,1,0,1
"4431",8,"HEAVY RAIN","FL",0,58500,0,0,58500,0
"4432",8,"HEAVY RAIN","GA",0,187000,1,4,187000,5
"4433",8,"HEAVY RAIN","IA",50000,150000,0,0,2e+05,0
"4434",8,"HEAVY RAIN","ID",0,115000,1,0,115000,1
"4435",8,"HEAVY RAIN","KS",0,325000,0,0,325000,0
"4436",8,"HEAVY RAIN","KY",0,10000,0,0,10000,0
"4437",8,"HEAVY RAIN","LA",0,5000,0,0,5000,0
"4438",8,"HEAVY RAIN","MD",0,3000,0,0,3000,0
"4439",8,"HEAVY RAIN","MN",5000,15000,0,0,20000,0
"4440",8,"HEAVY RAIN","MO",0,10000,0,0,10000,0
"4441",8,"HEAVY RAIN","MS",0,5000,0,0,5000,0
"4442",8,"HEAVY RAIN","MT",0,1000,0,0,1000,0
"4443",8,"HEAVY RAIN","NC",0,355000,0,0,355000,0
"4444",8,"HEAVY RAIN","ND",5020000,5e+06,0,0,10020000,0
"4445",8,"HEAVY RAIN","NE",1e+05,2000,0,0,102000,0
"4446",8,"HEAVY RAIN","NJ",0,110000,3,0,110000,3
"4447",8,"HEAVY RAIN","NM",0,72000,0,2,72000,2
"4448",8,"HEAVY RAIN","NY",0,5000,0,0,5000,0
"4449",8,"HEAVY RAIN","OH",0,1000,0,0,1000,0
"4450",8,"HEAVY RAIN","OK",0,15000,0,1,15000,1
"4451",8,"HEAVY RAIN","PA",0,0,0,2,0,2
"4452",8,"HEAVY RAIN","PR",0,78000,1,0,78000,1
"4453",8,"HEAVY RAIN","SC",0,230000,0,0,230000,0
"4454",8,"HEAVY RAIN","TN",0,5000,0,0,5000,0
"4455",8,"HEAVY RAIN","TX",0,54000,0,1,54000,1
"4456",8,"HEAVY RAIN","VA",0,36000,0,0,36000,0
"4457",8,"HEAVY RAIN","VT",0,160000,0,0,160000,0
"4458",8,"HEAVY RAIN","WA",450000,95000,1,0,545000,1
"4459",8,"HEAVY RAIN","WI",50000,191000,0,0,241000,0
"4460",8,"HEAVY RAIN","WV",0,30000,0,0,30000,0
"4461",8,"HEAVY RAIN","WY",0,3500,0,0,3500,0
"4462",8,"HEAVY SNOW","MT",0,5000,0,0,5000,0
"4463",8,"HIGH SURF","AL",0,1e+05,0,0,1e+05,0
"4464",8,"HIGH SURF","CA",0,20000,2,7,20000,9
"4465",8,"HIGH SURF","DE",0,0,0,11,0,11
"4466",8,"HIGH SURF","FL",0,2000,3,8,2000,11
"4467",8,"HIGH SURF","GA",0,10000,0,0,10000,0
"4468",8,"HIGH SURF","GU",0,0,2,4,0,6
"4469",8,"HIGH SURF","ME",0,75000,1,15,75000,16
"4470",8,"HIGH SURF","NJ",0,0,7,6,0,13
"4471",8,"HIGH SURF","PR",0,15000,0,0,15000,0
"4472",8,"HIGH SURF","RI",0,0,1,0,0,1
"4473",8,"HIGH SURF","SC",0,165000,0,0,165000,0
"4474",8,"HIGH SURF","VA",0,0,3,0,0,3
"4475",8,"HIGH WIND","AK",5000,7743000,0,0,7748000,0
"4476",8,"HIGH WIND","AZ",0,5000,0,1,5000,1
"4477",8,"HIGH WIND","CA",0,213000,0,3,213000,3
"4478",8,"HIGH WIND","CO",0,460000,0,6,460000,6
"4479",8,"HIGH WIND","FL",1.75e+08,2229195000,8,12,2404195000,20
"4480",8,"HIGH WIND","GU",1e+05,725000,0,2,825000,2
"4481",8,"HIGH WIND","IA",143000,568000,0,0,711000,0
"4482",8,"HIGH WIND","ID",0,50000,0,0,50000,0
"4483",8,"HIGH WIND","IL",0,0,0,1,0,1
"4484",8,"HIGH WIND","KS",0,5000,0,0,5000,0
"4485",8,"HIGH WIND","MN",0,6000,0,0,6000,0
"4486",8,"HIGH WIND","MS",0,53000,0,0,53000,0
"4487",8,"HIGH WIND","MT",0,503000,0,0,503000,0
"4488",8,"HIGH WIND","NC",5.1e+07,2210000,1,0,53210000,1
"4489",8,"HIGH WIND","NE",6000,36000,0,0,42000,0
"4490",8,"HIGH WIND","NM",0,30000,0,0,30000,0
"4491",8,"HIGH WIND","NY",1e+05,1180000,0,0,1280000,0
"4492",8,"HIGH WIND","OH",0,22000,0,8,22000,8
"4493",8,"HIGH WIND","OK",0,17000,0,2,17000,2
"4494",8,"HIGH WIND","OR",0,1000,0,0,1000,0
"4495",8,"HIGH WIND","PA",0,175000,1,0,175000,1
"4496",8,"HIGH WIND","RI",0,10000,0,0,10000,0
"4497",8,"HIGH WIND","SC",0,35000,0,0,35000,0
"4498",8,"HIGH WIND","TX",0,11000,0,0,11000,0
"4499",8,"HIGH WIND","UT",3000,87000,0,0,90000,0
"4500",8,"HIGH WIND","VT",250000,770000,0,0,1020000,0
"4501",8,"HIGH WIND","WA",30200000,372000,6,4,30572000,10
"4502",8,"HIGH WIND","WV",0,20000,0,0,20000,0
"4503",8,"HIGH WIND","WY",0,59000,0,13,59000,13
"4504",8,"HURRICANE/TYPHOON","AL",1e+06,1.025e+09,0,0,1.026e+09,0
"4505",8,"HURRICANE/TYPHOON","AR",7e+06,4e+05,0,0,7400000,0
"4506",8,"HURRICANE/TYPHOON","FL",843010000,5816460000,22,781,6659470000,803
"4507",8,"HURRICANE/TYPHOON","GU",1725000,69045000,0,17,70770000,17
"4508",8,"HURRICANE/TYPHOON","HI",0,5e+06,0,0,5e+06,0
"4509",8,"HURRICANE/TYPHOON","LA",4.9e+07,16933630000,0,0,16982630000,0
"4510",8,"HURRICANE/TYPHOON","MS",1.51e+09,13480100000,15,104,14990100000,119
"4511",8,"HURRICANE/TYPHOON","NC",253450000,177685000,2,4,431135000,6
"4512",8,"HURRICANE/TYPHOON","PR",0,501000,0,0,501000,0
"4513",8,"HURRICANE/TYPHOON","SC",0,10300000,0,3,10300000,3
"4514",8,"HURRICANE/TYPHOON","VA",3110000,23550000,0,4,26660000,4
"4515",8,"HURRICANE/TYPHOON","VI",0,2e+05,0,0,2e+05,0
"4516",8,"LIGHTNING","AK",0,1000,0,1,1000,1
"4517",8,"LIGHTNING","AL",10000,4070500,4,22,4080500,26
"4518",8,"LIGHTNING","AR",0,1922100,5,10,1922100,15
"4519",8,"LIGHTNING","AZ",0,1606000,4,39,1606000,43
"4520",8,"LIGHTNING","CA",40000,317500.5,0,6,357500.5,6
"4521",8,"LIGHTNING","CO",23600,4045542,9,68,4069142,77
"4522",8,"LIGHTNING","CT",0,360500,0,9,360500,9
"4523",8,"LIGHTNING","DC",0,10000,0,0,10000,0
"4524",8,"LIGHTNING","DE",0,2163000,0,2,2163000,2
"4525",8,"LIGHTNING","FL",0,18199000,28,177,18199000,205
"4526",8,"LIGHTNING","GA",5000,21314500,4,44,21319500,48
"4527",8,"LIGHTNING","GU",0,155000,1,0,155000,1
"4528",8,"LIGHTNING","HI",0,0,0,1,0,1
"4529",8,"LIGHTNING","IA",0,4348300,2,7,4348300,9
"4530",8,"LIGHTNING","ID",50000,782500,1,3,832500,4
"4531",8,"LIGHTNING","IL",0,1995500,3,12,1995500,15
"4532",8,"LIGHTNING","IN",0,4613600,1,12,4613600,13
"4533",8,"LIGHTNING","KS",9000,9914900,2,7,9923900,9
"4534",8,"LIGHTNING","KY",0,727000,5,8,727000,13
"4535",8,"LIGHTNING","LA",10000,2127250,0,29,2137250,29
"4536",8,"LIGHTNING","MA",0,6368000,1,43,6368000,44
"4537",8,"LIGHTNING","MD",0,4907300,1,17,4907300,18
"4538",8,"LIGHTNING","ME",0,1135000,1,10,1135000,11
"4539",8,"LIGHTNING","MI",0,4091100,2,11,4091100,13
"4540",8,"LIGHTNING","MN",0,1672000,3,12,1672000,15
"4541",8,"LIGHTNING","MO",0,474000,8,4,474000,12
"4542",8,"LIGHTNING","MS",0,4994250,5,2,4994250,7
"4543",8,"LIGHTNING","MT",0,571000,0,5,571000,5
"4544",8,"LIGHTNING","NC",0,7398600,6,56,7398600,62
"4545",8,"LIGHTNING","ND",10000,1169000,0,2,1179000,2
"4546",8,"LIGHTNING","NE",231600,3882500,1,9,4114100,10
"4547",8,"LIGHTNING","NH",0,1424000,0,38,1424000,38
"4548",8,"LIGHTNING","NJ",1000,4765500,3,52,4766500,55
"4549",8,"LIGHTNING","NM",0,220000,6,22,220000,28
"4550",8,"LIGHTNING","NV",0,1230000,0,5,1230000,5
"4551",8,"LIGHTNING","NY",10000,3561000,3,51,3571000,54
"4552",8,"LIGHTNING","OH",0,1526000,5,11,1526000,16
"4553",8,"LIGHTNING","OK",0,6014450,3,4,6014450,7
"4554",8,"LIGHTNING","OR",20000,443000,0,6,463000,6
"4555",8,"LIGHTNING","PA",0,9295500,5,53,9295500,58
"4556",8,"LIGHTNING","PR",0,24000,0,2,24000,2
"4557",8,"LIGHTNING","RI",0,538000,1,10,538000,11
"4558",8,"LIGHTNING","SC",0,9543000,7,20,9543000,27
"4559",8,"LIGHTNING","SD",0,797300,2,7,797300,9
"4560",8,"LIGHTNING","TN",30000,1061500,4,22,1091500,26
"4561",8,"LIGHTNING","TX",20000,6112300,14,54,6132300,68
"4562",8,"LIGHTNING","UT",50000,454500,8,17,504500,25
"4563",8,"LIGHTNING","VA",0,9207900,7,29,9207900,36
"4564",8,"LIGHTNING","VT",0,1375500,0,1,1375500,1
"4565",8,"LIGHTNING","WA",1e+05,1823500,1,10,1923500,11
"4566",8,"LIGHTNING","WI",0,33958500,5,13,33958500,18
"4567",8,"LIGHTNING","WV",0,1107700,3,10,1107700,13
"4568",8,"LIGHTNING","WY",40000,3e+05,1,8,340000,9
"4569",8,"MARINE STRONG WIND","AN",0,0,1,0,0,1
"4570",8,"MARINE STRONG WIND","GM",0,1000,0,0,1000,0
"4571",8,"MARINE STRONG WIND","LS",0,0,1,0,0,1
"4572",8,"MARINE THUNDERSTORM WIND","AM",0,0,1,1,0,2
"4573",8,"MARINE THUNDERSTORM WIND","AN",0,3000,0,0,3000,0
"4574",8,"MARINE THUNDERSTORM WIND","GM",0,7000,0,0,7000,0
"4575",8,"MARINE THUNDERSTORM WIND","LE",0,5000,0,0,5000,0
"4576",8,"MARINE THUNDERSTORM WIND","LM",0,535500,0,0,535500,0
"4577",8,"OTHER EVENT NON IDENTIFIED","NM",0,5000,0,0,5000,0
"4578",8,"RIP CURRENT","AL",0,0,3,0,0,3
"4579",8,"RIP CURRENT","CA",0,0,6,5,0,11
"4580",8,"RIP CURRENT","DE",0,0,2,9,0,11
"4581",8,"RIP CURRENT","FL",0,0,38,21,0,59
"4582",8,"RIP CURRENT","GA",0,0,0,2,0,2
"4583",8,"RIP CURRENT","GU",0,0,1,4,0,5
"4584",8,"RIP CURRENT","IN",0,0,8,4,0,12
"4585",8,"RIP CURRENT","MI",0,0,12,1,0,13
"4586",8,"RIP CURRENT","NC",0,0,11,5,0,16
"4587",8,"RIP CURRENT","NJ",0,0,5,15,0,20
"4588",8,"RIP CURRENT","NY",0,0,9,1,0,10
"4589",8,"RIP CURRENT","TX",0,0,3,0,0,3
"4590",8,"RIP CURRENT","VA",0,0,2,0,0,2
"4591",8,"STORM SURGE/TIDE","AK",0,10000,0,0,10000,0
"4592",8,"STORM SURGE/TIDE","FL",0,2915000,0,0,2915000,0
"4593",8,"STORM SURGE/TIDE","LA",0,3.13e+10,0,0,3.13e+10,0
"4594",8,"STORM SURGE/TIDE","MA",0,75000,0,0,75000,0
"4595",8,"STORM SURGE/TIDE","MS",0,1.126e+10,0,0,1.126e+10,0
"4596",8,"STORM SURGE/TIDE","NC",0,4e+07,0,0,4e+07,0
"4597",8,"STORM SURGE/TIDE","TX",0,135000,0,0,135000,0
"4598",8,"STRONG WIND","AL",0,13000,0,0,13000,0
"4599",8,"STRONG WIND","AZ",0,0,0,1,0,1
"4600",8,"STRONG WIND","CA",0,115000,0,1,115000,1
"4601",8,"STRONG WIND","CT",0,17500,0,0,17500,0
"4602",8,"STRONG WIND","GA",0,32250,0,0,32250,0
"4603",8,"STRONG WIND","IA",0,5000,0,0,5000,0
"4604",8,"STRONG WIND","IN",0,300,0,0,300,0
"4605",8,"STRONG WIND","KS",0,42850,0,0,42850,0
"4606",8,"STRONG WIND","KY",0,293000,0,0,293000,0
"4607",8,"STRONG WIND","LA",0,11000,0,0,11000,0
"4608",8,"STRONG WIND","MA",0,30990,0,0,30990,0
"4609",8,"STRONG WIND","MI",0,5000,0,0,5000,0
"4610",8,"STRONG WIND","MS",0,129500,0,0,129500,0
"4611",8,"STRONG WIND","NC",1.5e+07,355000,1,0,15355000,1
"4612",8,"STRONG WIND","NM",0,100,0,0,100,0
"4613",8,"STRONG WIND","NY",0,10000,0,0,10000,0
"4614",8,"STRONG WIND","OH",0,75000,1,0,75000,1
"4615",8,"STRONG WIND","OR",0,200,0,0,200,0
"4616",8,"STRONG WIND","PA",0,25000,1,1,25000,2
"4617",8,"STRONG WIND","PR",0,251000,0,0,251000,0
"4618",8,"STRONG WIND","RI",0,5000,0,0,5000,0
"4619",8,"STRONG WIND","SC",0,6500,0,0,6500,0
"4620",8,"STRONG WIND","TN",0,209000,0,0,209000,0
"4621",8,"STRONG WIND","TX",0,25000,0,0,25000,0
"4622",8,"STRONG WIND","UT",0,500,0,0,500,0
"4623",8,"STRONG WIND","VA",0,9000,0,0,9000,0
"4624",8,"STRONG WIND","VI",0,30000,0,0,30000,0
"4625",8,"STRONG WIND","VT",0,215000,0,0,215000,0
"4626",8,"STRONG WIND","WA",0,1000,0,0,1000,0
"4627",8,"STRONG WIND","WI",0,10000,0,0,10000,0
"4628",8,"THUNDERSTORM WIND","AL",17000,8216800,7,15,8233800,22
"4629",8,"THUNDERSTORM WIND","AR",1e+05,8218300,2,25,8318300,27
"4630",8,"THUNDERSTORM WIND","AZ",50000,183592700,2,68,183642700,70
"4631",8,"THUNDERSTORM WIND","CA",0,1708000,0,8,1708000,8
"4632",8,"THUNDERSTORM WIND","CO",0,5723953,1,19,5723953,20
"4633",8,"THUNDERSTORM WIND","CT",0,490500,0,2,490500,2
"4634",8,"THUNDERSTORM WIND","DC",0,1095500,1,6,1095500,7
"4635",8,"THUNDERSTORM WIND","DE",0,1520000,0,0,1520000,0
"4636",8,"THUNDERSTORM WIND","FL",10000,19464300,1,20,19474300,21
"4637",8,"THUNDERSTORM WIND","GA",125500,10627922,0,16,10753422,16
"4638",8,"THUNDERSTORM WIND","IA",29618400,30448400,0,54,60066800,54
"4639",8,"THUNDERSTORM WIND","ID",3000,1203100,5,95,1206100,100
"4640",8,"THUNDERSTORM WIND","IL",53069500,15898600,4,153,68968100,157
"4641",8,"THUNDERSTORM WIND","IN",60500,15780600,11,57,15841100,68
"4642",8,"THUNDERSTORM WIND","KS",4339000,36676150,2,61,41015150,63
"4643",8,"THUNDERSTORM WIND","KY",191000,5440800,5,8,5631800,13
"4644",8,"THUNDERSTORM WIND","LA",357000,13141600,4,10,13498600,14
"4645",8,"THUNDERSTORM WIND","MA",10000,8105000,0,18,8115000,18
"4646",8,"THUNDERSTORM WIND","MD",500,3359000,0,15,3359500,15
"4647",8,"THUNDERSTORM WIND","ME",0,518000,0,8,518000,8
"4648",8,"THUNDERSTORM WIND","MI",71000,10356000,8,21,10427000,29
"4649",8,"THUNDERSTORM WIND","MN",861250,13994450,1,11,14855700,12
"4650",8,"THUNDERSTORM WIND","MO",115000,8991400,6,72,9106400,78
"4651",8,"THUNDERSTORM WIND","MS",8508000,17686950,0,8,26194950,8
"4652",8,"THUNDERSTORM WIND","MT",6543000,2843500,2,3,9386500,5
"4653",8,"THUNDERSTORM WIND","NC",32000,5210150,1,30,5242150,31
"4654",8,"THUNDERSTORM WIND","ND",1775000,52872900,0,27,54647900,27
"4655",8,"THUNDERSTORM WIND","NE",30829000,14026400,1,21,44855400,22
"4656",8,"THUNDERSTORM WIND","NH",0,5758000,4,22,5758000,26
"4657",8,"THUNDERSTORM WIND","NJ",0,13783000,3,28,13783000,31
"4658",8,"THUNDERSTORM WIND","NM",210000,2368000,0,1,2578000,1
"4659",8,"THUNDERSTORM WIND","NV",0,884000,0,1,884000,1
"4660",8,"THUNDERSTORM WIND","NY",465000,24398500,1,44,24863500,45
"4661",8,"THUNDERSTORM WIND","OH",5060000,39557005,7,82,44617005,89
"4662",8,"THUNDERSTORM WIND","OK",0,35473550,1,36,35473550,37
"4663",8,"THUNDERSTORM WIND","OR",0,112100,0,5,112100,5
"4664",8,"THUNDERSTORM WIND","PA",5e+05,10479000,4,20,10979000,24
"4665",8,"THUNDERSTORM WIND","PR",0,571000,0,1,571000,1
"4666",8,"THUNDERSTORM WIND","RI",0,1407000,0,0,1407000,0
"4667",8,"THUNDERSTORM WIND","SC",45000,5745100,2,37,5790100,39
"4668",8,"THUNDERSTORM WIND","SD",1485050,27666000,0,25,29151050,25
"4669",8,"THUNDERSTORM WIND","TN",757000,8552200,0,23,9309200,23
"4670",8,"THUNDERSTORM WIND","TX",1281500,30060310,6,72,31341810,78
"4671",8,"THUNDERSTORM WIND","UT",145800,10251000,2,5,10396800,7
"4672",8,"THUNDERSTORM WIND","VA",353500,9406850,1,11,9760350,12
"4673",8,"THUNDERSTORM WIND","VI",0,7000,0,0,7000,0
"4674",8,"THUNDERSTORM WIND","VT",30000,6505500,0,7,6535500,7
"4675",8,"THUNDERSTORM WIND","WA",220000,304000,1,7,524000,8
"4676",8,"THUNDERSTORM WIND","WI",25951000,65549150,1,33,91500150,34
"4677",8,"THUNDERSTORM WIND","WV",0,3657600,2,4,3657600,6
"4678",8,"THUNDERSTORM WIND","WY",5000,408300,0,32,413300,32
"4679",8,"TORNADO","AL",0,18251150,1,19,18251150,20
"4680",8,"TORNADO","AR",0,3562500,0,13,3562500,13
"4681",8,"TORNADO","AZ",0,3936930,2,64,3936930,66
"4682",8,"TORNADO","CA",0,285000.5,0,1,285000.5,1
"4683",8,"TORNADO","CO",0,7251380,0,4,7251380,4
"4684",8,"TORNADO","CT",0,910840,0,17,910840,17
"4685",8,"TORNADO","DE",0,260000,0,1,260000,1
"4686",8,"TORNADO","FL",4000,108737990,1,94,108741990,95
"4687",8,"TORNADO","GA",505000,24463250,1,28,24968250,29
"4688",8,"TORNADO","IA",479600,25222600,3,68,25702200,71
"4689",8,"TORNADO","ID",0,338590,0,1,338590,1
"4690",8,"TORNADO","IL",2024000,304750780,35,440,306774780,475
"4691",8,"TORNADO","IN",26000,9730750,0,16,9756750,16
"4692",8,"TORNADO","KS",0,4404900,0,14,4404900,14
"4693",8,"TORNADO","KY",0,657560,0,9,657560,9
"4694",8,"TORNADO","LA",0,29586250,4,74,29586250,78
"4695",8,"TORNADO","MA",0,30770560,7,53,30770560,60
"4696",8,"TORNADO","MD",0,3860750,0,2,3860750,2
"4697",8,"TORNADO","ME",0,3245250,1,5,3245250,6
"4698",8,"TORNADO","MI",371000,88953810,1,44,89324810,45
"4699",8,"TORNADO","MN",4684000,91032750,22,196,95716750,218
"4700",8,"TORNADO","MO",0,26113090,1,18,26113090,19
"4701",8,"TORNADO","MS",1575000,1960810,1,5,3535810,6
"4702",8,"TORNADO","MT",0,4709280,0,4,4709280,4
"4703",8,"TORNADO","NC",170000,12527090,3,67,12697090,70
"4704",8,"TORNADO","ND",2280000,59738960,2,47,62018960,49
"4705",8,"TORNADO","NE",86000,24994900,1,33,25080900,34
"4706",8,"TORNADO","NH",0,3990000,0,6,3990000,6
"4707",8,"TORNADO","NJ",0,8357500,0,3,8357500,3
"4708",8,"TORNADO","NM",0,365310,0,0,365310,0
"4709",8,"TORNADO","NV",0,750060,0,0,750060,0
"4710",8,"TORNADO","NY",55000,15785030,3,38,15840030,41
"4711",8,"TORNADO","OH",93000,22724500,10,283,22817500,293
"4712",8,"TORNADO","OK",0,2488620,1,8,2488620,9
"4713",8,"TORNADO","OR",0,75000,0,0,75000,0
"4714",8,"TORNADO","PA",38000,84861280,3,94,84899280,97
"4715",8,"TORNADO","PR",1000,385000,0,0,386000,0
"4716",8,"TORNADO","RI",0,3e+06,0,20,3e+06,20
"4717",8,"TORNADO","SC",0,60364400,1,142,60364400,143
"4718",8,"TORNADO","SD",4100,22859090,0,14,22863190,14
"4719",8,"TORNADO","TN",0,2935280,0,37,2935280,37
"4720",8,"TORNADO","TX",4000,391404470,0,76,391408470,76
"4721",8,"TORNADO","UT",502000,170381210,1,87,170883210,88
"4722",8,"TORNADO","VA",0,129573780,4,274,129573780,278
"4723",8,"TORNADO","VT",0,2605250,0,7,2605250,7
"4724",8,"TORNADO","WA",0,280030,0,0,280030,0
"4725",8,"TORNADO","WI",3516400,122719250,10,363,126235650,373
"4726",8,"TORNADO","WV",0,3504250,0,0,3504250,0
"4727",8,"TORNADO","WY",0,6189620,2,15,6189620,17
"4728",8,"TROPICAL DEPRESSION","AL",0,5000,0,0,5000,0
"4729",8,"TROPICAL DEPRESSION","GU",0,50000,0,0,50000,0
"4730",8,"TROPICAL STORM","AL",0,35410000,0,8,35410000,8
"4731",8,"TROPICAL STORM","AR",0,10000,0,0,10000,0
"4732",8,"TROPICAL STORM","CT",0,6e+07,0,0,6e+07,0
"4733",8,"TROPICAL STORM","DC",0,2400000,0,0,2400000,0
"4734",8,"TROPICAL STORM","FL",16305000,242805200,3,2,259110200,5
"4735",8,"TROPICAL STORM","GA",0,1971000,0,0,1971000,0
"4736",8,"TROPICAL STORM","GU",0,5000,0,0,5000,0
"4737",8,"TROPICAL STORM","LA",0,190000,0,0,190000,0
"4738",8,"TROPICAL STORM","MA",0,34702000,0,0,34702000,0
"4739",8,"TROPICAL STORM","MD",5e+05,4570000,0,0,5070000,0
"4740",8,"TROPICAL STORM","MS",0,470000,0,0,470000,0
"4741",8,"TROPICAL STORM","NC",41700000,14565700,0,1,56265700,1
"4742",8,"TROPICAL STORM","NH",0,25000,1,1,25000,2
"4743",8,"TROPICAL STORM","NJ",0,1.5e+07,0,0,1.5e+07,0
"4744",8,"TROPICAL STORM","PA",0,2750000,2,0,2750000,2
"4745",8,"TROPICAL STORM","PR",2100000,5609000,0,0,7709000,0
"4746",8,"TROPICAL STORM","RI",0,190000,0,0,190000,0
"4747",8,"TROPICAL STORM","SC",1e+05,26964500,0,0,27064500,0
"4748",8,"TROPICAL STORM","TN",0,235000,0,0,235000,0
"4749",8,"TROPICAL STORM","TX",0,385000,0,0,385000,0
"4750",8,"TROPICAL STORM","VA",9e+06,5638500,1,0,14638500,1
"4751",8,"TROPICAL STORM","VI",5000,50000,0,0,55000,0
"4752",8,"WATERSPOUT","AN",0,11000,0,0,11000,0
"4753",8,"WATERSPOUT","FL",0,90500,0,27,90500,27
"4754",8,"WATERSPOUT","GM",0,200,0,0,200,0
"4755",8,"WATERSPOUT","MD",0,10000,0,0,10000,0
"4756",8,"WATERSPOUT","NY",0,1e+06,0,0,1e+06,0
"4757",8,"WATERSPOUT","VA",0,2000,0,0,2000,0
"4758",8,"WILDFIRE","AK",0,1150000,0,0,1150000,0
"4759",8,"WILDFIRE","AR",0,6710000,0,1,6710000,1
"4760",8,"WILDFIRE","CA",250000,146687000,1,137,146937000,138
"4761",8,"WILDFIRE","CO",0,2550000,0,0,2550000,0
"4762",8,"WILDFIRE","GA",0,3000,0,0,3000,0
"4763",8,"WILDFIRE","HI",2200000,960000,0,5,3160000,5
"4764",8,"WILDFIRE","ID",265000,6140000,1,0,6405000,1
"4765",8,"WILDFIRE","KY",0,10000,0,0,10000,0
"4766",8,"WILDFIRE","MI",0,40000,0,0,40000,0
"4767",8,"WILDFIRE","MT",0,9370000,0,16,9370000,16
"4768",8,"WILDFIRE","NM",0,25000,0,0,25000,0
"4769",8,"WILDFIRE","OK",0,2125000,0,1,2125000,1
"4770",8,"WILDFIRE","OR",1e+05,9100000,0,4,9200000,4
"4771",8,"WILDFIRE","SD",14000,14000,0,0,28000,0
"4772",8,"WILDFIRE","TX",69000,20026500,0,6,20095500,6
"4773",8,"WILDFIRE","WA",82171000,12676000,0,3,94847000,3
"4774",8,"WILDFIRE","WY",0,1305000,1,1,1305000,2
"4775",8,"WINTER STORM","WY",0,0,0,1,0,1
"4776",9,"COASTAL FLOOD","AK",0,12060,0,0,12060,0
"4777",9,"COASTAL FLOOD","AL",0,5000,0,0,5000,0
"4778",9,"COASTAL FLOOD","MD",0,5e+06,0,1,5e+06,1
"4779",9,"COASTAL FLOOD","ME",0,55000,0,1,55000,1
"4780",9,"COASTAL FLOOD","NC",0,1908000,0,0,1908000,0
"4781",9,"COASTAL FLOOD","NH",0,2500,0,0,2500,0
"4782",9,"COASTAL FLOOD","NJ",0,3e+05,0,0,3e+05,0
"4783",9,"COASTAL FLOOD","PA",0,50000,0,0,50000,0
"4784",9,"COASTAL FLOOD","VA",0,47795000,0,0,47795000,0
"4785",9,"COLD/WIND CHILL","IA",1.5e+07,0,0,0,1.5e+07,0
"4786",9,"COLD/WIND CHILL","ID",5e+06,0,0,0,5e+06,0
"4787",9,"COLD/WIND CHILL","KS",0,2.5e+07,0,0,2.5e+07,0
"4788",9,"DEBRIS FLOW","CA",0,80000,0,0,80000,0
"4789",9,"DEBRIS FLOW","CO",0,130000,1,0,130000,1
"4790",9,"DEBRIS FLOW","GA",0,1e+05,0,0,1e+05,0
"4791",9,"DEBRIS FLOW","MT",0,0,0,2,0,2
"4792",9,"DEBRIS FLOW","NC",0,30260000,4,9,30260000,13
"4793",9,"DEBRIS FLOW","PR",0,3000,0,0,3000,0
"4794",9,"DENSE FOG","CA",0,251000,0,0,251000,0
"4795",9,"DENSE FOG","SD",0,30000,2,3,30000,5
"4796",9,"DENSE FOG","VA",0,5e+05,0,0,5e+05,0
"4797",9,"DENSE FOG","WY",0,14000,0,0,14000,0
"4798",9,"DROUGHT","AL",1e+05,0,0,0,1e+05,0
"4799",9,"DROUGHT","AR",3e+05,0,0,0,3e+05,0
"4800",9,"DROUGHT","DE",29100000,0,0,0,29100000,0
"4801",9,"DROUGHT","GA",410540000,0,0,0,410540000,0
"4802",9,"DROUGHT","IA",160960000,0,0,0,160960000,0
"4803",9,"DROUGHT","IL",5.6e+07,0,0,0,5.6e+07,0
"4804",9,"DROUGHT","IN",7.3e+07,0,0,0,7.3e+07,0
"4805",9,"DROUGHT","KS",61950000,0,0,0,61950000,0
"4806",9,"DROUGHT","KY",2.26e+08,0,0,0,2.26e+08,0
"4807",9,"DROUGHT","LA",5e+05,0,0,0,5e+05,0
"4808",9,"DROUGHT","MS",5e+05,0,0,0,5e+05,0
"4809",9,"DROUGHT","NC",1e+07,0,0,0,1e+07,0
"4810",9,"DROUGHT","NE",2.4e+08,0,0,0,2.4e+08,0
"4811",9,"DROUGHT","NJ",8e+07,0,0,0,8e+07,0
"4812",9,"DROUGHT","NY",5e+07,0,0,0,5e+07,0
"4813",9,"DROUGHT","OH",2e+08,0,0,0,2e+08,0
"4814",9,"DROUGHT","OK",1250000,45000,0,0,1295000,0
"4815",9,"DROUGHT","PA",3.8e+07,5000,0,0,38005000,0
"4816",9,"DROUGHT","TX",271995000,12020000,0,0,284015000,0
"4817",9,"DROUGHT","VA",93270000,0,0,0,93270000,0
"4818",9,"DROUGHT","WI",26000,0,0,0,26000,0
"4819",9,"DUST DEVIL","CA",0,100,0,1,100,1
"4820",9,"DUST DEVIL","CO",0,2000,0,0,2000,0
"4821",9,"DUST DEVIL","LA",0,10000,0,0,10000,0
"4822",9,"DUST DEVIL","MT",0,3000,0,0,3000,0
"4823",9,"DUST DEVIL","TN",0,1000,0,2,1000,2
"4824",9,"DUST STORM","AZ",0,3e+05,0,5,3e+05,5
"4825",9,"DUST STORM","CA",0,10000,0,4,10000,4
"4826",9,"DUST STORM","CO",0,80000,0,0,80000,0
"4827",9,"DUST STORM","MT",0,0,1,8,0,9
"4828",9,"DUST STORM","NV",0,10000,0,0,10000,0
"4829",9,"DUST STORM","OR",0,150000,0,5,150000,5
"4830",9,"DUST STORM","WA",0,60000,0,4,60000,4
"4831",9,"FLASH FLOOD","AL",15055000,13582000,0,1,28637000,1
"4832",9,"FLASH FLOOD","AR",250000,14238010,2,3,14488010,5
"4833",9,"FLASH FLOOD","AZ",5e+06,8618000,7,6,13618000,13
"4834",9,"FLASH FLOOD","CA",0,11053000,0,6,11053000,6
"4835",9,"FLASH FLOOD","CO",0,2419000,0,3,2419000,3
"4836",9,"FLASH FLOOD","CT",0,183000,1,0,183000,1
"4837",9,"FLASH FLOOD","DC",0,50000,0,0,50000,0
"4838",9,"FLASH FLOOD","DE",0,24474000,2,3,24474000,5
"4839",9,"FLASH FLOOD","FL",0,4065000,1,0,4065000,1
"4840",9,"FLASH FLOOD","GA",2218000,63086720,9,2,65304720,11
"4841",9,"FLASH FLOOD","GU",0,12000,0,0,12000,0
"4842",9,"FLASH FLOOD","HI",0,1575050,0,2,1575050,2
"4843",9,"FLASH FLOOD","IA",1105000,5480000,0,0,6585000,0
"4844",9,"FLASH FLOOD","ID",0,115000,0,0,115000,0
"4845",9,"FLASH FLOOD","IL",4011000,112488500,2,1,116499500,3
"4846",9,"FLASH FLOOD","IN",5000,40915000,2,1,40920000,3
"4847",9,"FLASH FLOOD","KS",1327000,9287100,1,2,10614100,3
"4848",9,"FLASH FLOOD","KY",0,2900000,4,0,2900000,4
"4849",9,"FLASH FLOOD","LA",1100000,21827000,0,0,22927000,0
"4850",9,"FLASH FLOOD","MA",0,244000,0,0,244000,0
"4851",9,"FLASH FLOOD","MD",75000,23093000,0,21,23168000,21
"4852",9,"FLASH FLOOD","ME",0,1932000,0,0,1932000,0
"4853",9,"FLASH FLOOD","MI",1e+05,849000,0,0,949000,0
"4854",9,"FLASH FLOOD","MN",61500,10222500,1,0,10284000,1
"4855",9,"FLASH FLOOD","MO",11026000,73698000,7,5,84724000,12
"4856",9,"FLASH FLOOD","MS",2600000,13806500,1,1,16406500,2
"4857",9,"FLASH FLOOD","MT",0,10000,0,0,10000,0
"4858",9,"FLASH FLOOD","NC",136205000,23481000,21,2,159686000,23
"4859",9,"FLASH FLOOD","ND",0,48000,0,0,48000,0
"4860",9,"FLASH FLOOD","NE",2200000,703000,0,0,2903000,0
"4861",9,"FLASH FLOOD","NH",0,760000,0,0,760000,0
"4862",9,"FLASH FLOOD","NJ",0,504350000,3,186,504350000,189
"4863",9,"FLASH FLOOD","NM",31000,2903500,4,1,2934500,5
"4864",9,"FLASH FLOOD","NV",5000,4158000,0,0,4163000,0
"4865",9,"FLASH FLOOD","NY",0,311128000,1,0,311128000,1
"4866",9,"FLASH FLOOD","OH",135000,10557000,0,0,10692000,0
"4867",9,"FLASH FLOOD","OK",0,8640000,5,2,8640000,7
"4868",9,"FLASH FLOOD","PA",20000,354344000,13,38,354364000,51
"4869",9,"FLASH FLOOD","PR",0,22188000,9,0,22188000,9
"4870",9,"FLASH FLOOD","RI",0,77000,0,0,77000,0
"4871",9,"FLASH FLOOD","SC",0,1565500,0,1,1565500,1
"4872",9,"FLASH FLOOD","SD",0,1214000,0,0,1214000,0
"4873",9,"FLASH FLOOD","TN",51000,1924010,0,0,1975010,0
"4874",9,"FLASH FLOOD","TX",863000,56202500,12,46,57065500,58
"4875",9,"FLASH FLOOD","UT",117000,5660000,4,3,5777000,7
"4876",9,"FLASH FLOOD","VA",12065050,48123750,8,1,60188800,9
"4877",9,"FLASH FLOOD","WA",0,428000,0,0,428000,0
"4878",9,"FLASH FLOOD","WI",66000,69494500,1,1,69560500,2
"4879",9,"FLASH FLOOD","WV",545000,4930000,2,4,5475000,6
"4880",9,"FLASH FLOOD","WY",0,107000,0,0,107000,0
"4881",9,"FLOOD","AK",0,10013000,0,0,10013000,0
"4882",9,"FLOOD","AL",0,35000,0,0,35000,0
"4883",9,"FLOOD","AR",2980000,2475000,0,0,5455000,0
"4884",9,"FLOOD","AS",0,80000,0,0,80000,0
"4885",9,"FLOOD","AZ",0,500,0,0,500,0
"4886",9,"FLOOD","CA",0,105000,0,0,105000,0
"4887",9,"FLOOD","CO",0,2000,0,0,2000,0
"4888",9,"FLOOD","CT",0,2420000,1,0,2420000,1
"4889",9,"FLOOD","DC",0,150000,0,0,150000,0
"4890",9,"FLOOD","FL",7500,26063000,3,1,26070500,4
"4891",9,"FLOOD","GA",75000,270781500,2,1,270856500,3
"4892",9,"FLOOD","GU",0,180000,0,0,180000,0
"4893",9,"FLOOD","HI",0,4e+05,0,0,4e+05,0
"4894",9,"FLOOD","IA",5070000,13097000,0,120,18167000,120
"4895",9,"FLOOD","ID",0,70000,0,0,70000,0
"4896",9,"FLOOD","IL",10000,13030000,1,8,13040000,9
"4897",9,"FLOOD","IN",4e+05,44900000,1,0,45300000,1
"4898",9,"FLOOD","KS",7585000,52265100,3,0,59850100,3
"4899",9,"FLOOD","KY",5500000,1987000,1,0,7487000,1
"4900",9,"FLOOD","LA",0,660000,0,0,660000,0
"4901",9,"FLOOD","MA",0,547000,0,0,547000,0
"4902",9,"FLOOD","MD",230000,12230000,1,0,12460000,1
"4903",9,"FLOOD","ME",0,1634000,0,0,1634000,0
"4904",9,"FLOOD","MI",0,35870000,0,0,35870000,0
"4905",9,"FLOOD","MN",21665000,72742000,1,0,94407000,1
"4906",9,"FLOOD","MO",17500000,1320000,0,0,18820000,0
"4907",9,"FLOOD","MS",0,1e+05,0,0,1e+05,0
"4908",9,"FLOOD","NC",109601900,226503000,17,1,336104900,18
"4909",9,"FLOOD","ND",0,1e+08,0,0,1e+08,0
"4910",9,"FLOOD","NE",6e+05,2192000,0,0,2792000,0
"4911",9,"FLOOD","NH",0,1153170,0,0,1153170,0
"4912",9,"FLOOD","NJ",0,77200000,3,0,77200000,3
"4913",9,"FLOOD","NM",0,550000,0,0,550000,0
"4914",9,"FLOOD","NY",0,835119000,2,0,835119000,2
"4915",9,"FLOOD","OH",0,52619500,2,0,52619500,2
"4916",9,"FLOOD","OK",0,5130000,0,0,5130000,0
"4917",9,"FLOOD","OR",0,1e+06,0,0,1e+06,0
"4918",9,"FLOOD","PA",1400000,631052000,21,93,632452000,114
"4919",9,"FLOOD","PR",0,6115050,1,0,6115050,1
"4920",9,"FLOOD","SC",5e+06,3284500,1,0,8284500,1
"4921",9,"FLOOD","SD",0,4e+05,0,0,4e+05,0
"4922",9,"FLOOD","TN",0,1161000,2,1,1161000,3
"4923",9,"FLOOD","TX",0,22656000,1,2,22656000,3
"4924",9,"FLOOD","UT",42500,331000,0,0,373500,0
"4925",9,"FLOOD","VA",36066000,111091500,3,2,147157500,5
"4926",9,"FLOOD","VT",0,777000,0,0,777000,0
"4927",9,"FLOOD","WA",0,60000,0,0,60000,0
"4928",9,"FLOOD","WI",3982000,12258140,1,1,16240140,2
"4929",9,"FLOOD","WV",950000,135043000,2,0,135993000,2
"4930",9,"FROST/FREEZE","IA",295500000,0,0,0,295500000,0
"4931",9,"FROST/FREEZE","MT",0,5e+05,0,0,5e+05,0
"4932",9,"FROST/FREEZE","NE",312200000,0,0,0,312200000,0
"4933",9,"FROST/FREEZE","NY",5e+06,0,0,0,5e+06,0
"4934",9,"FROST/FREEZE","VT",5e+06,0,0,0,5e+06,0
"4935",9,"FUNNEL CLOUD","MS",0,100,0,0,100,0
"4936",9,"FUNNEL CLOUD","WA",0,2000,0,0,2000,0
"4937",9,"HAIL","AL",7000,39000,0,0,46000,0
"4938",9,"HAIL","AR",5000,63110,0,0,68110,0
"4939",9,"HAIL","AZ",72000,18617500,0,2,18689500,2
"4940",9,"HAIL","CA",10000,227000,0,0,237000,0
"4941",9,"HAIL","CO",510500,1385000,0,0,1895500,0
"4942",9,"HAIL","CT",0,5000,0,0,5000,0
"4943",9,"HAIL","FL",0,80000,0,0,80000,0
"4944",9,"HAIL","GA",5000,173500,0,0,178500,0
"4945",9,"HAIL","IA",2950500,33198700,0,0,36149200,0
"4946",9,"HAIL","ID",60000,0,0,0,60000,0
"4947",9,"HAIL","IL",172000,2232000,0,0,2404000,0
"4948",9,"HAIL","IN",0,151000,0,0,151000,0
"4949",9,"HAIL","KS",7210500,159831250,0,13,167041750,13
"4950",9,"HAIL","KY",0,789000,0,0,789000,0
"4951",9,"HAIL","LA",0,7000,0,0,7000,0
"4952",9,"HAIL","MA",50000,30000,0,0,80000,0
"4953",9,"HAIL","MD",50050,500,0,0,50550,0
"4954",9,"HAIL","ME",0,500,0,0,500,0
"4955",9,"HAIL","MI",1170000,12780000,0,15,13950000,15
"4956",9,"HAIL","MN",6248000,72036500,0,1,78284500,1
"4957",9,"HAIL","MO",5000,1760100,0,0,1765100,0
"4958",9,"HAIL","MS",0,28880,0,0,28880,0
"4959",9,"HAIL","MT",3000,10000,0,0,13000,0
"4960",9,"HAIL","NC",13500000,1004000,0,0,14504000,0
"4961",9,"HAIL","ND",740000,31158000,0,0,31898000,0
"4962",9,"HAIL","NE",18939000,6685000,0,0,25624000,0
"4963",9,"HAIL","NM",850000,11451500,0,1,12301500,1
"4964",9,"HAIL","NV",0,75000,0,0,75000,0
"4965",9,"HAIL","NY",802000,958000,0,1,1760000,1
"4966",9,"HAIL","OH",1995000,12413000,0,1,14408000,1
"4967",9,"HAIL","OK",0,421200,0,1,421200,1
"4968",9,"HAIL","OR",2110000,15000,0,0,2125000,0
"4969",9,"HAIL","PA",5000,530000,0,0,535000,0
"4970",9,"HAIL","PR",0,1000,0,0,1000,0
"4971",9,"HAIL","SC",0,55000,0,0,55000,0
"4972",9,"HAIL","SD",3615500,2786050,0,0,6401550,0
"4973",9,"HAIL","TN",0,1980,0,0,1980,0
"4974",9,"HAIL","TX",28520500,161931500,1,15,190452000,16
"4975",9,"HAIL","UT",1700,138000,0,2,139700,2
"4976",9,"HAIL","VA",50600,16800,0,0,67400,0
"4977",9,"HAIL","VI",0,15000,0,0,15000,0
"4978",9,"HAIL","WA",0,50000,0,10,50000,10
"4979",9,"HAIL","WI",224500,31440250,0,0,31664750,0
"4980",9,"HAIL","WV",5000,1665500,0,0,1670500,0
"4981",9,"HAIL","WY",2000,7500,0,0,9500,0
"4982",9,"HEAT","AL",0,0,1,0,0,1
"4983",9,"HEAT","AZ",0,0,2,0,0,2
"4984",9,"HEAT","CA",0,0,7,7,0,14
"4985",9,"HEAT","FL",0,0,1,8,0,9
"4986",9,"HEAT","KY",0,0,0,65,0,65
"4987",9,"HEAT","MO",0,0,4,51,0,55
"4988",9,"HEAT","NV",0,0,3,0,0,3
"4989",9,"HEAT","OK",0,0,2,0,0,2
"4990",9,"HEAT","PA",0,0,1,0,0,1
"4991",9,"HEAT","TX",0,0,60,0,0,60
"4992",9,"HEAVY RAIN","AK",10000,7512500,0,0,7522500,0
"4993",9,"HEAVY RAIN","AL",0,26000,1,2,26000,3
"4994",9,"HEAVY RAIN","AR",1e+06,10000,1,1,1010000,2
"4995",9,"HEAVY RAIN","AZ",0,103000,0,0,103000,0
"4996",9,"HEAVY RAIN","CA",10250000,25000,0,0,10275000,0
"4997",9,"HEAVY RAIN","CO",10000,48000,0,0,58000,0
"4998",9,"HEAVY RAIN","CT",0,1e+05,0,0,1e+05,0
"4999",9,"HEAVY RAIN","FL",0,124000,0,0,124000,0
"5000",9,"HEAVY RAIN","GA",0,719500,0,0,719500,0
"5001",9,"HEAVY RAIN","IA",10000,75000,0,0,85000,0
"5002",9,"HEAVY RAIN","KS",0,205000,0,1,205000,1
"5003",9,"HEAVY RAIN","KY",0,15000,0,0,15000,0
"5004",9,"HEAVY RAIN","MD",0,0,0,2,0,2
"5005",9,"HEAVY RAIN","MI",0,770000,0,0,770000,0
"5006",9,"HEAVY RAIN","MO",0,10,0,0,10,0
"5007",9,"HEAVY RAIN","NC",0,186000,0,2,186000,2
"5008",9,"HEAVY RAIN","NE",1e+06,22000,0,0,1022000,0
"5009",9,"HEAVY RAIN","NJ",0,1650000,0,2,1650000,2
"5010",9,"HEAVY RAIN","NM",0,3e+05,0,0,3e+05,0
"5011",9,"HEAVY RAIN","NY",0,30000,0,0,30000,0
"5012",9,"HEAVY RAIN","PR",0,34050,0,2,34050,2
"5013",9,"HEAVY RAIN","SC",0,780500,1,0,780500,1
"5014",9,"HEAVY RAIN","SD",0,1e+05,0,0,1e+05,0
"5015",9,"HEAVY RAIN","TN",0,10000,0,0,10000,0
"5016",9,"HEAVY RAIN","TX",0,295000,0,0,295000,0
"5017",9,"HEAVY RAIN","UT",0,8000,0,0,8000,0
"5018",9,"HEAVY RAIN","WA",0,210000,0,0,210000,0
"5019",9,"HEAVY RAIN","WI",0,15000,0,0,15000,0
"5020",9,"HEAVY SNOW","CA",0,0,1,0,0,1
"5021",9,"HEAVY SNOW","CO",5e+06,5000,0,0,5005000,0
"5022",9,"HEAVY SNOW","KS",50010000,6000,0,0,50016000,0
"5023",9,"HEAVY SNOW","MT",0,14000,0,0,14000,0
"5024",9,"HEAVY SNOW","NE",3e+06,5000,0,0,3005000,0
"5025",9,"HEAVY SNOW","WY",0,1000,0,0,1000,0
"5026",9,"HIGH SURF","AK",0,130000,0,0,130000,0
"5027",9,"HIGH SURF","AS",0,5000,0,4,5000,4
"5028",9,"HIGH SURF","CA",0,10000,0,7,10000,7
"5029",9,"HIGH SURF","DE",0,1e+05,0,0,1e+05,0
"5030",9,"HIGH SURF","FL",0,2740000,1,2,2740000,3
"5031",9,"HIGH SURF","GA",0,7500,0,0,7500,0
"5032",9,"HIGH SURF","HI",0,0,0,1,0,1
"5033",9,"HIGH SURF","NC",0,0,1,0,0,1
"5034",9,"HIGH SURF","NJ",0,4e+06,2,0,4e+06,2
"5035",9,"HIGH SURF","NY",0,0,1,0,0,1
"5036",9,"HIGH SURF","OR",0,1e+06,0,0,1e+06,0
"5037",9,"HIGH SURF","PR",0,50000,2,1,50000,3
"5038",9,"HIGH SURF","RI",0,0,3,0,0,3
"5039",9,"HIGH SURF","SC",0,14000,0,0,14000,0
"5040",9,"HIGH SURF","TX",0,0,2,2,0,4
"5041",9,"HIGH SURF","VA",0,80000,0,0,80000,0
"5042",9,"HIGH SURF","VI",0,0,1,0,0,1
"5043",9,"HIGH WIND","AK",0,561500,0,0,561500,0
"5044",9,"HIGH WIND","AL",1365000,82888000,0,5,84253000,5
"5045",9,"HIGH WIND","AR",0,375000,0,0,375000,0
"5046",9,"HIGH WIND","CA",0,50,0,0,50,0
"5047",9,"HIGH WIND","CO",0,2000,0,0,2000,0
"5048",9,"HIGH WIND","CT",0,270000,2,0,270000,2
"5049",9,"HIGH WIND","DC",0,15000,0,0,15000,0
"5050",9,"HIGH WIND","DE",0,14880000,0,0,14880000,0
"5051",9,"HIGH WIND","FL",82500000,852720000,0,0,935220000,0
"5052",9,"HIGH WIND","GA",26500000,29200300,0,2,55700300,2
"5053",9,"HIGH WIND","IA",1e+05,105000,0,0,205000,0
"5054",9,"HIGH WIND","ID",0,139500,0,0,139500,0
"5055",9,"HIGH WIND","IL",13015000,14684000,0,1,27699000,1
"5056",9,"HIGH WIND","IN",3e+06,22514000,5,6,25514000,11
"5057",9,"HIGH WIND","KS",0,5000,0,0,5000,0
"5058",9,"HIGH WIND","KY",15300000,84543000,1,25,99843000,26
"5059",9,"HIGH WIND","MA",0,620000,0,2,620000,2
"5060",9,"HIGH WIND","MD",305000,12132000,0,3,12437000,3
"5061",9,"HIGH WIND","ME",0,5e+06,0,0,5e+06,0
"5062",9,"HIGH WIND","MI",0,132000,1,0,132000,1
"5063",9,"HIGH WIND","MN",0,7000,0,0,7000,0
"5064",9,"HIGH WIND","MO",1e+07,19615000,0,1,29615000,1
"5065",9,"HIGH WIND","MS",0,2830000,0,0,2830000,0
"5066",9,"HIGH WIND","MT",0,50000,0,0,50000,0
"5067",9,"HIGH WIND","NC",72020000,65184000,2,5,137204000,7
"5068",9,"HIGH WIND","NE",0,10000,0,0,10000,0
"5069",9,"HIGH WIND","NH",0,60000,0,0,60000,0
"5070",9,"HIGH WIND","NJ",0,7500000,4,16,7500000,20
"5071",9,"HIGH WIND","NM",0,15000,0,0,15000,0
"5072",9,"HIGH WIND","NV",0,30000,1,1,30000,2
"5073",9,"HIGH WIND","NY",425000,10713010,1,7,11138010,8
"5074",9,"HIGH WIND","OH",5e+06,586372000,3,1,591372000,4
"5075",9,"HIGH WIND","OK",0,40000,0,0,40000,0
"5076",9,"HIGH WIND","OR",0,1002000,8,33,1002000,41
"5077",9,"HIGH WIND","PA",0,53712500,2,0,53712500,2
"5078",9,"HIGH WIND","RI",0,80000,0,0,80000,0
"5079",9,"HIGH WIND","SC",5100000,2760000,1,6,7860000,7
"5080",9,"HIGH WIND","SD",0,90000,0,0,90000,0
"5081",9,"HIGH WIND","TN",1710000,646000,0,0,2356000,0
"5082",9,"HIGH WIND","TX",0,170000,0,0,170000,0
"5083",9,"HIGH WIND","UT",50000,50000,0,1,1e+05,1
"5084",9,"HIGH WIND","VA",19975000,62140000,3,71,82115000,74
"5085",9,"HIGH WIND","VT",35000,2590000,1,0,2625000,1
"5086",9,"HIGH WIND","WA",40000,71000,0,0,111000,0
"5087",9,"HIGH WIND","WI",0,19000,0,0,19000,0
"5088",9,"HIGH WIND","WV",790100,1491000,0,3,2281100,3
"5089",9,"HIGH WIND","WY",0,10000,0,1,10000,1
"5090",9,"HURRICANE/TYPHOON","AL",3e+07,2674170000,1,0,2704170000,1
"5091",9,"HURRICANE/TYPHOON","AR",7e+05,350000,0,0,1050000,0
"5092",9,"HURRICANE/TYPHOON","DE",0,50000,0,0,50000,0
"5093",9,"HURRICANE/TYPHOON","FL",261900000,10776595000,15,21,11038495000,36
"5094",9,"HURRICANE/TYPHOON","GU",330000,395000,0,1,725000,1
"5095",9,"HURRICANE/TYPHOON","LA",175800000,4608512000,2,0,4784312000,2
"5096",9,"HURRICANE/TYPHOON","MD",575000,1278000,0,0,1853000,0
"5097",9,"HURRICANE/TYPHOON","ME",0,0,0,2,0,2
"5098",9,"HURRICANE/TYPHOON","MS",2830800,694875000,1,0,697705800,1
"5099",9,"HURRICANE/TYPHOON","NC",1058750000,5223955000,28,11,6282705000,39
"5100",9,"HURRICANE/TYPHOON","NJ",0,1150000,0,0,1150000,0
"5101",9,"HURRICANE/TYPHOON","PR",4.31e+08,1.725e+09,18,0,2.156e+09,18
"5102",9,"HURRICANE/TYPHOON","SC",19800000,1.8e+07,1,0,37800000,1
"5103",9,"HURRICANE/TYPHOON","TX",0,4132260000,6,15,4132260000,21
"5104",9,"HURRICANE/TYPHOON","VA",56920000,611417000,5,0,668337000,5
"5105",9,"HURRICANE/TYPHOON","VI",0,2e+06,0,0,2e+06,0
"5106",9,"LIGHTNING","AL",240,1565000,2,17,1565240,19
"5107",9,"LIGHTNING","AR",0,887000,1,3,887000,4
"5108",9,"LIGHTNING","AZ",0,605000,3,13,605000,16
"5109",9,"LIGHTNING","CA",0,334200,3,15,334200,18
"5110",9,"LIGHTNING","CO",20000,834025,9,21,854025,30
"5111",9,"LIGHTNING","CT",0,5000,0,14,5000,14
"5112",9,"LIGHTNING","DE",0,156000,0,1,156000,1
"5113",9,"LIGHTNING","FL",25000,4309150,19,103,4334150,122
"5114",9,"LIGHTNING","GA",0,4171500,2,22,4171500,24
"5115",9,"LIGHTNING","GU",0,20000,0,0,20000,0
"5116",9,"LIGHTNING","IA",0,483200,2,4,483200,6
"5117",9,"LIGHTNING","ID",0,366000,0,3,366000,3
"5118",9,"LIGHTNING","IL",0,363000,1,6,363000,7
"5119",9,"LIGHTNING","IN",0,740000,0,12,740000,12
"5120",9,"LIGHTNING","KS",0,1689503,1,7,1689503,8
"5121",9,"LIGHTNING","KY",18000,70000,1,2,88000,3
"5122",9,"LIGHTNING","LA",0,2178000,2,3,2178000,5
"5123",9,"LIGHTNING","MA",0,232000,1,2,232000,3
"5124",9,"LIGHTNING","MD",0,161000,1,0,161000,1
"5125",9,"LIGHTNING","ME",0,314000,0,0,314000,0
"5126",9,"LIGHTNING","MI",0,1530500,2,6,1530500,8
"5127",9,"LIGHTNING","MN",50000,1508000,0,4,1558000,4
"5128",9,"LIGHTNING","MO",2000,808200,0,0,810200,0
"5129",9,"LIGHTNING","MS",0,407000,0,1,407000,1
"5130",9,"LIGHTNING","MT",3000,5000,1,4,8000,5
"5131",9,"LIGHTNING","NC",0,1045000,2,4,1045000,6
"5132",9,"LIGHTNING","ND",0,115000,0,1,115000,1
"5133",9,"LIGHTNING","NE",61000,1377000,0,0,1438000,0
"5134",9,"LIGHTNING","NH",0,263000,0,0,263000,0
"5135",9,"LIGHTNING","NJ",0,2e+05,2,7,2e+05,9
"5136",9,"LIGHTNING","NM",0,130000,3,4,130000,7
"5137",9,"LIGHTNING","NV",0,331000,0,4,331000,4
"5138",9,"LIGHTNING","NY",0,475000,1,6,475000,7
"5139",9,"LIGHTNING","OH",0,240000,2,10,240000,12
"5140",9,"LIGHTNING","OK",0,1473000,0,10,1473000,10
"5141",9,"LIGHTNING","OR",0,5000,0,0,5000,0
"5142",9,"LIGHTNING","PA",3e+05,1182500,2,2,1482500,4
"5143",9,"LIGHTNING","PR",0,10000,4,1,10000,5
"5144",9,"LIGHTNING","RI",0,45000,0,0,45000,0
"5145",9,"LIGHTNING","SC",0,2918000,2,2,2918000,4
"5146",9,"LIGHTNING","SD",0,114650,0,0,114650,0
"5147",9,"LIGHTNING","TN",0,436500,2,2,436500,4
"5148",9,"LIGHTNING","TX",0,3867000,6,58,3867000,64
"5149",9,"LIGHTNING","UT",0,76700,2,2,76700,4
"5150",9,"LIGHTNING","VA",0,1132500,0,4,1132500,4
"5151",9,"LIGHTNING","VI",0,0,1,1,0,2
"5152",9,"LIGHTNING","VT",0,60000,0,0,60000,0
"5153",9,"LIGHTNING","WA",0,110500,1,2,110500,3
"5154",9,"LIGHTNING","WI",0,1826000,0,2,1826000,2
"5155",9,"LIGHTNING","WV",0,532000,0,0,532000,0
"5156",9,"LIGHTNING","WY",0,1000,1,4,1000,5
"5157",9,"MARINE HIGH WIND","AN",0,75000,0,0,75000,0
"5158",9,"MARINE HIGH WIND","LM",0,10000,0,0,10000,0
"5159",9,"MARINE STRONG WIND","PZ",0,0,1,0,0,1
"5160",9,"MARINE THUNDERSTORM WIND","AN",0,0,1,0,0,1
"5161",9,"MARINE THUNDERSTORM WIND","GM",0,3100000,0,0,3100000,0
"5162",9,"MARINE THUNDERSTORM WIND","LE",0,25000,0,0,25000,0
"5163",9,"MARINE THUNDERSTORM WIND","LM",0,90000,0,0,90000,0
"5164",9,"OTHER EVENT NON IDENTIFIED","NM",0,5000,0,0,5000,0
"5165",9,"OTHER EVENT NON IDENTIFIED","NV",0,500,0,0,500,0
"5166",9,"RIP CURRENT","AL",0,0,5,1,0,6
"5167",9,"RIP CURRENT","CA",0,0,1,2,0,3
"5168",9,"RIP CURRENT","DE",0,0,2,0,0,2
"5169",9,"RIP CURRENT","FL",0,0,29,10,0,39
"5170",9,"RIP CURRENT","GU",0,0,3,0,0,3
"5171",9,"RIP CURRENT","LA",0,0,1,2,0,3
"5172",9,"RIP CURRENT","MI",0,0,2,4,0,6
"5173",9,"RIP CURRENT","NC",0,0,9,0,0,9
"5174",9,"RIP CURRENT","NJ",0,0,6,10,0,16
"5175",9,"RIP CURRENT","NY",0,0,1,2,0,3
"5176",9,"RIP CURRENT","SC",0,0,1,0,0,1
"5177",9,"STORM SURGE/TIDE","AK",0,2693000,0,0,2693000,0
"5178",9,"STORM SURGE/TIDE","AL",0,4400000,0,0,4400000,0
"5179",9,"STORM SURGE/TIDE","DC",0,75000,0,0,75000,0
"5180",9,"STORM SURGE/TIDE","FL",0,28125000,0,1,28125000,1
"5181",9,"STORM SURGE/TIDE","LA",0,521285000,0,0,521285000,0
"5182",9,"STORM SURGE/TIDE","MD",5000,54150000,0,0,54155000,0
"5183",9,"STORM SURGE/TIDE","MS",0,3760000,0,0,3760000,0
"5184",9,"STORM SURGE/TIDE","NC",0,1250000,0,0,1250000,0
"5185",9,"STORM SURGE/TIDE","PA",0,0,0,1,0,1
"5186",9,"STORM SURGE/TIDE","TX",0,4500265000,11,0,4500265000,11
"5187",9,"STORM SURGE/TIDE","VA",0,1780000,0,0,1780000,0
"5188",9,"STRONG WIND","AL",0,264000,0,2,264000,2
"5189",9,"STRONG WIND","AR",0,50000,0,0,50000,0
"5190",9,"STRONG WIND","CA",0,87200,0,0,87200,0
"5191",9,"STRONG WIND","CO",0,15300,0,0,15300,0
"5192",9,"STRONG WIND","CT",0,516000,0,0,516000,0
"5193",9,"STRONG WIND","DC",0,25000,0,0,25000,0
"5194",9,"STRONG WIND","DE",0,416250,0,0,416250,0
"5195",9,"STRONG WIND","FL",48400000,80430010,1,0,128830010,1
"5196",9,"STRONG WIND","GA",0,1763750,0,0,1763750,0
"5197",9,"STRONG WIND","IA",0,6010,0,0,6010,0
"5198",9,"STRONG WIND","IL",0,9000,0,0,9000,0
"5199",9,"STRONG WIND","IN",0,2540,0,0,2540,0
"5200",9,"STRONG WIND","KS",3000,150000,0,0,153000,0
"5201",9,"STRONG WIND","KY",0,149750,0,0,149750,0
"5202",9,"STRONG WIND","LA",0,0,1,0,0,1
"5203",9,"STRONG WIND","MA",0,43000,0,0,43000,0
"5204",9,"STRONG WIND","MD",0,641000,0,0,641000,0
"5205",9,"STRONG WIND","ME",0,4000,1,0,4000,1
"5206",9,"STRONG WIND","MI",0,16000,0,0,16000,0
"5207",9,"STRONG WIND","MN",0,1100,0,2,1100,2
"5208",9,"STRONG WIND","MO",0,15000,0,0,15000,0
"5209",9,"STRONG WIND","MS",0,117000,0,0,117000,0
"5210",9,"STRONG WIND","NC",0,170500,0,0,170500,0
"5211",9,"STRONG WIND","NE",0,0,0,1,0,1
"5212",9,"STRONG WIND","NH",0,0,0,2,0,2
"5213",9,"STRONG WIND","NJ",0,3561000,0,5,3561000,5
"5214",9,"STRONG WIND","NM",0,10000,0,0,10000,0
"5215",9,"STRONG WIND","NV",0,10000,0,2,10000,2
"5216",9,"STRONG WIND","NY",0,245500,0,1,245500,1
"5217",9,"STRONG WIND","OH",0,578000,0,0,578000,0
"5218",9,"STRONG WIND","OK",0,60000,0,0,60000,0
"5219",9,"STRONG WIND","PA",0,167940,1,0,167940,1
"5220",9,"STRONG WIND","PR",0,6500,0,0,6500,0
"5221",9,"STRONG WIND","RI",0,5000,0,0,5000,0
"5222",9,"STRONG WIND","SC",0,3000,0,0,3000,0
"5223",9,"STRONG WIND","TN",0,10000,1,0,10000,1
"5224",9,"STRONG WIND","TX",0,13000,1,0,13000,1
"5225",9,"STRONG WIND","UT",0,17000,0,0,17000,0
"5226",9,"STRONG WIND","VA",0,2000,0,0,2000,0
"5227",9,"STRONG WIND","VT",0,6000,0,0,6000,0
"5228",9,"STRONG WIND","WA",0,102000,0,0,102000,0
"5229",9,"STRONG WIND","WI",0,87850,0,1,87850,1
"5230",9,"STRONG WIND","WV",0,70000,0,0,70000,0
"5231",9,"THUNDERSTORM WIND","AK",0,5e+05,0,0,5e+05,0
"5232",9,"THUNDERSTORM WIND","AL",35000,1219500,0,1,1254500,1
"5233",9,"THUNDERSTORM WIND","AR",0,8609900,1,2,8609900,3
"5234",9,"THUNDERSTORM WIND","AZ",0,56467500,1,21,56467500,22
"5235",9,"THUNDERSTORM WIND","CA",10000,5133000,0,0,5143000,0
"5236",9,"THUNDERSTORM WIND","CO",0,1051500,0,2,1051500,2
"5237",9,"THUNDERSTORM WIND","CT",0,76500,0,6,76500,6
"5238",9,"THUNDERSTORM WIND","DC",0,20500,0,0,20500,0
"5239",9,"THUNDERSTORM WIND","DE",0,16000,0,0,16000,0
"5240",9,"THUNDERSTORM WIND","FL",0,1271000,0,6,1271000,6
"5241",9,"THUNDERSTORM WIND","GA",3500,3570250,0,4,3573750,4
"5242",9,"THUNDERSTORM WIND","IA",60899000,7616500,0,4,68515500,4
"5243",9,"THUNDERSTORM WIND","ID",0,60000,0,1,60000,1
"5244",9,"THUNDERSTORM WIND","IL",579000,3019000,0,5,3598000,5
"5245",9,"THUNDERSTORM WIND","IN",1000,1612000,0,19,1613000,19
"5246",9,"THUNDERSTORM WIND","KS",550000,4461150,0,1,5011150,1
"5247",9,"THUNDERSTORM WIND","KY",20500,887000,0,3,907500,3
"5248",9,"THUNDERSTORM WIND","LA",172000,2250000,1,7,2422000,8
"5249",9,"THUNDERSTORM WIND","MA",0,462000,0,3,462000,3
"5250",9,"THUNDERSTORM WIND","MD",0,393000,2,1,393000,3
"5251",9,"THUNDERSTORM WIND","ME",0,1000,1,0,1000,1
"5252",9,"THUNDERSTORM WIND","MI",5000,2174200,1,34,2179200,35
"5253",9,"THUNDERSTORM WIND","MN",15000,253260300,1,7,253275300,8
"5254",9,"THUNDERSTORM WIND","MO",18000,3646500,0,1,3664500,1
"5255",9,"THUNDERSTORM WIND","MS",447000,1617100,0,0,2064100,0
"5256",9,"THUNDERSTORM WIND","MT",0,22500,0,4,22500,4
"5257",9,"THUNDERSTORM WIND","NC",0,1290200,0,3,1290200,3
"5258",9,"THUNDERSTORM WIND","ND",405000,554000,0,3,959000,3
"5259",9,"THUNDERSTORM WIND","NE",3750000,3767100,0,7,7517100,7
"5260",9,"THUNDERSTORM WIND","NH",0,30000,1,0,30000,1
"5261",9,"THUNDERSTORM WIND","NJ",0,9325500,1,43,9325500,44
"5262",9,"THUNDERSTORM WIND","NM",20000,349500,0,5,369500,5
"5263",9,"THUNDERSTORM WIND","NV",0,211000,4,1,211000,5
"5264",9,"THUNDERSTORM WIND","NY",10550000,178534000,5,26,189084000,31
"5265",9,"THUNDERSTORM WIND","OH",55000,12911002,5,19,12966002,24
"5266",9,"THUNDERSTORM WIND","OK",0,20004740,1,50,20004740,51
"5267",9,"THUNDERSTORM WIND","PA",0,3378000,2,16,3378000,18
"5268",9,"THUNDERSTORM WIND","PR",0,73560,0,0,73560,0
"5269",9,"THUNDERSTORM WIND","RI",0,10000,0,0,10000,0
"5270",9,"THUNDERSTORM WIND","SC",0,3254850,0,2,3254850,2
"5271",9,"THUNDERSTORM WIND","SD",550,494000,2,5,494550,7
"5272",9,"THUNDERSTORM WIND","TN",124000,3833550,0,0,3957550,0
"5273",9,"THUNDERSTORM WIND","TX",210000,22346700,3,44,22556700,47
"5274",9,"THUNDERSTORM WIND","UT",32000,122000,0,0,154000,0
"5275",9,"THUNDERSTORM WIND","VA",5050,9275900,0,16,9280950,16
"5276",9,"THUNDERSTORM WIND","VT",0,3e+05,0,0,3e+05,0
"5277",9,"THUNDERSTORM WIND","WA",0,2000,0,0,2000,0
"5278",9,"THUNDERSTORM WIND","WI",463500,13897150,0,8,14360650,8
"5279",9,"THUNDERSTORM WIND","WV",5000,947500,0,2,952500,2
"5280",9,"THUNDERSTORM WIND","WY",0,260000,0,0,260000,0
"5281",9,"TORNADO","AL",102000,9053250,0,18,9155250,18
"5282",9,"TORNADO","AR",75000,5014250,1,42,5089250,43
"5283",9,"TORNADO","AZ",30000,4355060,0,4,4385060,4
"5284",9,"TORNADO","CA",0,2975100,0,3,2975100,3
"5285",9,"TORNADO","CO",0,383590,0,4,383590,4
"5286",9,"TORNADO","CT",0,2750000,0,2,2750000,2
"5287",9,"TORNADO","DC",0,2000,0,0,2000,0
"5288",9,"TORNADO","DE",5000,1352500,0,5,1357500,5
"5289",9,"TORNADO","FL",0,48272070,9,64,48272070,73
"5290",9,"TORNADO","GA",28000,51268780,1,56,51296780,57
"5291",9,"TORNADO","HI",0,2500,0,0,2500,0
"5292",9,"TORNADO","IA",2212000,51415250,6,74,53627250,80
"5293",9,"TORNADO","ID",0,1e+05,0,0,1e+05,0
"5294",9,"TORNADO","IL",40000,27700250,2,93,27740250,95
"5295",9,"TORNADO","IN",178000,119029750,2,157,119207750,159
"5296",9,"TORNADO","KS",5000,289832310,5,68,289837310,73
"5297",9,"TORNADO","KY",0,1985000,1,5,1985000,6
"5298",9,"TORNADO","LA",203000,23841310,9,150,24044310,159
"5299",9,"TORNADO","MA",0,563000,1,2,563000,3
"5300",9,"TORNADO","MD",0,109138000,2,59,109138000,61
"5301",9,"TORNADO","ME",0,430000,0,1,430000,1
"5302",9,"TORNADO","MI",125000,34721780,1,12,34846780,13
"5303",9,"TORNADO","MN",0,68673090,4,60,68673090,64
"5304",9,"TORNADO","MO",15000,20025595,0,21,20040595,21
"5305",9,"TORNADO","MS",3225000,19842980,1,29,23067980,30
"5306",9,"TORNADO","MT",0,25000,0,0,25000,0
"5307",9,"TORNADO","NC",0,17596500,0,22,17596500,22
"5308",9,"TORNADO","ND",0,360250,0,0,360250,0
"5309",9,"TORNADO","NE",1725000,7985120,0,15,9710120,15
"5310",9,"TORNADO","NJ",0,4868250,0,1,4868250,1
"5311",9,"TORNADO","NM",5000,1105280,0,0,1110280,0
"5312",9,"TORNADO","NV",0,280000,0,0,280000,0
"5313",9,"TORNADO","NY",5e+05,35508780,3,19,36008780,22
"5314",9,"TORNADO","OH",164000,69271500,2,160,69435500,162
"5315",9,"TORNADO","OK",0,4827930,2,33,4827930,35
"5316",9,"TORNADO","OR",23000,90000,0,1,113000,1
"5317",9,"TORNADO","PA",0,3.3e+07,1,51,3.3e+07,52
"5318",9,"TORNADO","RI",0,250000,0,3,250000,3
"5319",9,"TORNADO","SC",0,26493250,6,92,26493250,98
"5320",9,"TORNADO","SD",0,1052560,0,1,1052560,1
"5321",9,"TORNADO","TN",1000,474250,0,7,475250,7
"5322",9,"TORNADO","TX",15000,138599980,15,319,138614980,334
"5323",9,"TORNADO","UT",101000,2755030,0,1,2856030,1
"5324",9,"TORNADO","VA",15000,88838600,13,62,88853600,75
"5325",9,"TORNADO","VT",50000,5e+05,0,0,550000,0
"5326",9,"TORNADO","WA",0,430030,0,0,430030,0
"5327",9,"TORNADO","WI",61000,63140500,7,67,63201500,74
"5328",9,"TORNADO","WV",0,1405000,1,16,1405000,17
"5329",9,"TORNADO","WY",0,252530,0,0,252530,0
"5330",9,"TROPICAL DEPRESSION","AR",0,1e+06,0,0,1e+06,0
"5331",9,"TROPICAL DEPRESSION","MS",0,10000,0,0,10000,0
"5332",9,"TROPICAL DEPRESSION","NC",0,30000,0,0,30000,0
"5333",9,"TROPICAL DEPRESSION","TN",0,595000,0,0,595000,0
"5334",9,"TROPICAL DEPRESSION","TX",0,5000,0,0,5000,0
"5335",9,"TROPICAL STORM","AL",0,10220000,0,0,10220000,0
"5336",9,"TROPICAL STORM","AR",2e+05,2598000,0,1,2798000,1
"5337",9,"TROPICAL STORM","AZ",2e+08,0,0,0,2e+08,0
"5338",9,"TROPICAL STORM","CA",4500000,0,0,0,4500000,0
"5339",9,"TROPICAL STORM","CT",0,4000,0,0,4000,0
"5340",9,"TROPICAL STORM","DC",0,125200000,0,0,125200000,0
"5341",9,"TROPICAL STORM","DE",0,17750000,0,0,17750000,0
"5342",9,"TROPICAL STORM","FL",0,377295000,7,7,377295000,14
"5343",9,"TROPICAL STORM","GA",2200000,12800000,0,0,1.5e+07,0
"5344",9,"TROPICAL STORM","GU",50000,610000,0,0,660000,0
"5345",9,"TROPICAL STORM","LA",154600000,272779000,1,12,427379000,13
"5346",9,"TROPICAL STORM","MA",0,30000,0,0,30000,0
"5347",9,"TROPICAL STORM","MD",190000,533835000,1,200,534025000,201
"5348",9,"TROPICAL STORM","MO",0,150000,0,2,150000,2
"5349",9,"TROPICAL STORM","MS",0,25620000,1,0,25620000,1
"5350",9,"TROPICAL STORM","NC",60435000,22056400,0,0,82491400,0
"5351",9,"TROPICAL STORM","NJ",0,2600000,0,0,2600000,0
"5352",9,"TROPICAL STORM","NY",0,4000,1,1,4000,2
"5353",9,"TROPICAL STORM","OK",0,25000,0,0,25000,0
"5354",9,"TROPICAL STORM","PA",0,1e+05,0,0,1e+05,0
"5355",9,"TROPICAL STORM","PR",101505000,68050000,5,2,169555000,7
"5356",9,"TROPICAL STORM","RI",0,13000,0,0,13000,0
"5357",9,"TROPICAL STORM","SC",0,2250,0,0,2250,0
"5358",9,"TROPICAL STORM","TX",1e+06,337053000,3,3,338053000,6
"5359",9,"TROPICAL STORM","VA",8600000,102215000,4,29,110815000,33
"5360",9,"TROPICAL STORM","VI",0,6200000,0,0,6200000,0
"5361",9,"TSUNAMI","AS",20000,8.1e+07,32,129,81020000,161
"5362",9,"WATERSPOUT","FL",0,5500,0,0,5500,0
"5363",9,"WATERSPOUT","GM",0,50000,0,0,50000,0
"5364",9,"WATERSPOUT","PR",0,5500,0,0,5500,0
"5365",9,"WILDFIRE","AL",0,1e+05,0,0,1e+05,0
"5366",9,"WILDFIRE","AR",0,40000,0,0,40000,0
"5367",9,"WILDFIRE","CA",5e+05,710619060,0,137,711119060,137
"5368",9,"WILDFIRE","CO",0,2.19e+08,0,0,2.19e+08,0
"5369",9,"WILDFIRE","HI",6630,0,0,0,6630,0
"5370",9,"WILDFIRE","IA",0,1e+05,0,0,1e+05,0
"5371",9,"WILDFIRE","ID",0,4240000,0,0,4240000,0
"5372",9,"WILDFIRE","LA",0,1106000,0,1,1106000,1
"5373",9,"WILDFIRE","MT",5e+05,5420000,0,9,5920000,9
"5374",9,"WILDFIRE","OK",0,1750000,0,0,1750000,0
"5375",9,"WILDFIRE","OR",0,1700000,0,0,1700000,0
"5376",9,"WILDFIRE","SD",0,3000,0,0,3000,0
"5377",9,"WILDFIRE","TX",413000,292601000,5,6,293014000,11
"5378",9,"WILDFIRE","UT",0,5e+06,0,6,5e+06,6
"5379",9,"WILDFIRE","VA",0,10000,0,2,10000,2
"5380",9,"WILDFIRE","WA",0,4500000,0,0,4500000,0
"5381",9,"WILDFIRE","WY",0,1100000,0,9,1100000,9
"5382",9,"WINTER STORM","NE",0,8000,0,0,8000,0
"5383",9,"WINTER STORM","WY",0,113000,1,1,113000,2
"5384",9,"WINTER WEATHER","CO",0,0,1,0,0,1
"5385",10,"AVALANCHE","CO",0,0,0,1,0,1
"5386",10,"BLIZZARD","AK",0,0,1,0,0,1
"5387",10,"BLIZZARD","CO",0,2200000,10,2,2200000,12
"5388",10,"BLIZZARD","KS",0,5e+06,0,1,5e+06,1
"5389",10,"BLIZZARD","MT",0,50000,0,0,50000,0
"5390",10,"BLIZZARD","ND",0,2200000,0,0,2200000,0
"5391",10,"BLIZZARD","NE",50000,1e+05,0,3,150000,3
"5392",10,"BLIZZARD","OK",7e+06,1500000,1,0,8500000,1
"5393",10,"BLIZZARD","WY",10000,325000,0,0,335000,0
"5394",10,"COASTAL FLOOD","AL",0,20000,0,0,20000,0
"5395",10,"COASTAL FLOOD","FL",0,625000,0,0,625000,0
"5396",10,"COASTAL FLOOD","LA",0,5515000,0,0,5515000,0
"5397",10,"COASTAL FLOOD","MA",0,30000,0,0,30000,0
"5398",10,"COASTAL FLOOD","MD",0,10000,0,0,10000,0
"5399",10,"COASTAL FLOOD","ME",0,766000,0,0,766000,0
"5400",10,"COASTAL FLOOD","NH",0,27500,0,0,27500,0
"5401",10,"COASTAL FLOOD","NY",0,11501000,0,0,11501000,0
"5402",10,"COASTAL FLOOD","PR",0,5000,0,0,5000,0
"5403",10,"COASTAL FLOOD","RI",0,14000,0,0,14000,0
"5404",10,"COASTAL FLOOD","SC",56000,27300000,0,0,27356000,0
"5405",10,"COASTAL FLOOD","TX",0,21325000,0,0,21325000,0
"5406",10,"COASTAL FLOOD","VA",0,265000,0,0,265000,0
"5407",10,"COASTAL FLOOD","WA",0,150000,0,0,150000,0
"5408",10,"COLD/WIND CHILL","AR",750000,0,0,0,750000,0
"5409",10,"DEBRIS FLOW","CA",0,48055000,0,0,48055000,0
"5410",10,"DEBRIS FLOW","CO",0,13000,0,0,13000,0
"5411",10,"DEBRIS FLOW","PR",0,1e+05,2,2,1e+05,4
"5412",10,"DEBRIS FLOW","UT",0,1.2e+07,0,0,1.2e+07,0
"5413",10,"DEBRIS FLOW","WA",0,25150000,0,0,25150000,0
"5414",10,"DENSE FOG","CA",0,170000,0,3,170000,3
"5415",10,"DENSE FOG","ID",0,50000,0,0,50000,0
"5416",10,"DENSE FOG","MD",0,0,1,30,0,31
"5417",10,"DENSE FOG","MI",0,0,1,1,0,2
"5418",10,"DENSE FOG","NC",0,2500,0,0,2500,0
"5419",10,"DENSE FOG","OH",0,150000,2,16,150000,18
"5420",10,"DENSE FOG","PA",0,0,0,15,0,15
"5421",10,"DENSE FOG","TX",0,25000,0,0,25000,0
"5422",10,"DENSE FOG","WA",0,50000,0,0,50000,0
"5423",10,"DENSE FOG","WI",0,0,11,0,0,11
"5424",10,"DROUGHT","AR",1300000,0,0,0,1300000,0
"5425",10,"DROUGHT","LA",1e+06,0,0,0,1e+06,0
"5426",10,"DROUGHT","MO",665000,0,0,0,665000,0
"5427",10,"DROUGHT","MS",8e+05,0,0,0,8e+05,0
"5428",10,"DROUGHT","NC",2775000,0,0,0,2775000,0
"5429",10,"DROUGHT","OK",5e+05,20000,0,0,520000,0
"5430",10,"DROUGHT","TX",279525000,10500000,0,0,290025000,0
"5431",10,"DROUGHT","VA",46500000,0,0,0,46500000,0
"5432",10,"DROUGHT","WI",10000,0,0,0,10000,0
"5433",10,"DROUGHT","WV",310000,0,0,0,310000,0
"5434",10,"DUST STORM","AZ",0,4e+05,0,15,4e+05,15
"5435",10,"DUST STORM","CA",0,940000,3,8,940000,11
"5436",10,"DUST STORM","WA",0,0,0,20,0,20
"5437",10,"FLASH FLOOD","AL",0,279000,0,0,279000,0
"5438",10,"FLASH FLOOD","AR",2150000,140862000,1,1,143012000,2
"5439",10,"FLASH FLOOD","AZ",3e+06,11874100,1,0,14874100,1
"5440",10,"FLASH FLOOD","CA",0,9036000,2,4,9036000,6
"5441",10,"FLASH FLOOD","CO",0,1e+06,0,0,1e+06,0
"5442",10,"FLASH FLOOD","CT",0,2032000,0,0,2032000,0
"5443",10,"FLASH FLOOD","FL",2.9e+08,209930900,0,0,499930900,0
"5444",10,"FLASH FLOOD","GA",5500,11016000,0,0,11021500,0
"5445",10,"FLASH FLOOD","GU",75000,205000,0,0,280000,0
"5446",10,"FLASH FLOOD","HI",0,80448000,0,0,80448000,0
"5447",10,"FLASH FLOOD","IA",80000,796000,0,0,876000,0
"5448",10,"FLASH FLOOD","IL",10000,1193000,0,0,1203000,0
"5449",10,"FLASH FLOOD","IN",0,2000,1,0,2000,1
"5450",10,"FLASH FLOOD","KS",1000,24525500,2,15,24526500,17
"5451",10,"FLASH FLOOD","KY",0,66000,0,0,66000,0
"5452",10,"FLASH FLOOD","LA",3800000,32776000,1,0,36576000,1
"5453",10,"FLASH FLOOD","MA",0,16600000,0,0,16600000,0
"5454",10,"FLASH FLOOD","MD",0,15000,0,0,15000,0
"5455",10,"FLASH FLOOD","ME",0,5e+05,0,0,5e+05,0
"5456",10,"FLASH FLOOD","MI",0,60000,0,0,60000,0
"5457",10,"FLASH FLOOD","MN",0,3e+06,0,0,3e+06,0
"5458",10,"FLASH FLOOD","MO",0,28896000,10,0,28896000,10
"5459",10,"FLASH FLOOD","MS",3650000,8031000,3,0,11681000,3
"5460",10,"FLASH FLOOD","NC",0,1134500,0,0,1134500,0
"5461",10,"FLASH FLOOD","NH",0,11075000,2,0,11075000,2
"5462",10,"FLASH FLOOD","NJ",0,41700000,0,1,41700000,1
"5463",10,"FLASH FLOOD","NM",0,120000,1,0,120000,1
"5464",10,"FLASH FLOOD","NV",0,1079100,0,0,1079100,0
"5465",10,"FLASH FLOOD","NY",0,26922000,1,0,26922000,1
"5466",10,"FLASH FLOOD","OH",0,252000,0,0,252000,0
"5467",10,"FLASH FLOOD","OK",0,10695000,0,3,10695000,3
"5468",10,"FLASH FLOOD","PA",0,350000,1,2,350000,3
"5469",10,"FLASH FLOOD","PR",0,6008650,4,0,6008650,4
"5470",10,"FLASH FLOOD","SC",24000,2763000,0,0,2787000,0
"5471",10,"FLASH FLOOD","TN",0,436500,0,0,436500,0
"5472",10,"FLASH FLOOD","TX",3738000,345172756,29,75,348910756,104
"5473",10,"FLASH FLOOD","UT",0,8702000,0,0,8702000,0
"5474",10,"FLASH FLOOD","VA",2680000,9550500,0,0,12230500,0
"5475",10,"FLASH FLOOD","VI",0,2e+05,0,0,2e+05,0
"5476",10,"FLASH FLOOD","VT",0,510000,0,0,510000,0
"5477",10,"FLASH FLOOD","WI",0,570000,0,0,570000,0
"5478",10,"FLOOD","AK",0,70573000,0,0,70573000,0
"5479",10,"FLOOD","AL",0,5000,0,0,5000,0
"5480",10,"FLOOD","AR",2100000,3585000,2,0,5685000,2
"5481",10,"FLOOD","AZ",10000,143000,0,0,153000,0
"5482",10,"FLOOD","CA",150000,1612000,0,6,1762000,6
"5483",10,"FLOOD","CT",0,6015000,2,0,6015000,2
"5484",10,"FLOOD","DE",0,6e+05,0,0,6e+05,0
"5485",10,"FLOOD","FL",5.91e+08,474378000,0,0,1065378000,0
"5486",10,"FLOOD","GA",265050,6239050,0,0,6504100,0
"5487",10,"FLOOD","GU",0,4e+05,0,0,4e+05,0
"5488",10,"FLOOD","IA",650000,1137000,0,0,1787000,0
"5489",10,"FLOOD","IL",0,50000,1,0,50000,1
"5490",10,"FLOOD","IN",5e+05,5e+05,0,0,1e+06,0
"5491",10,"FLOOD","KS",403000,5853200,0,0,6256200,0
"5492",10,"FLOOD","KY",0,25000,0,0,25000,0
"5493",10,"FLOOD","LA",0,641716000,0,0,641716000,0
"5494",10,"FLOOD","MA",0,10614000,0,0,10614000,0
"5495",10,"FLOOD","MD",0,2e+05,0,2,2e+05,2
"5496",10,"FLOOD","ME",0,28211000,1,0,28211000,1
"5497",10,"FLOOD","MN",0,10000,0,0,10000,0
"5498",10,"FLOOD","MO",0,1060000,3,1,1060000,4
"5499",10,"FLOOD","MS",0,160000,0,0,160000,0
"5500",10,"FLOOD","NC",0,360000,0,0,360000,0
"5501",10,"FLOOD","NE",25000,78000,0,0,103000,0
"5502",10,"FLOOD","NH",2e+05,17480000,2,0,17680000,2
"5503",10,"FLOOD","NJ",0,13370000,0,0,13370000,0
"5504",10,"FLOOD","NM",0,40000,0,0,40000,0
"5505",10,"FLOOD","NV",0,25000,0,0,25000,0
"5506",10,"FLOOD","NY",0,9463000,2,3,9463000,5
"5507",10,"FLOOD","OH",0,83000,0,0,83000,0
"5508",10,"FLOOD","OK",0,736000,1,1,736000,2
"5509",10,"FLOOD","PA",0,6875000,1,0,6875000,1
"5510",10,"FLOOD","PR",0,20028500,0,0,20028500,0
"5511",10,"FLOOD","RI",0,1638000,0,0,1638000,0
"5512",10,"FLOOD","SC",0,575000,0,0,575000,0
"5513",10,"FLOOD","TN",0,26000,0,0,26000,0
"5514",10,"FLOOD","TX",48706000,639140400,27,6030,687846400,6057
"5515",10,"FLOOD","UT",0,530000,0,0,530000,0
"5516",10,"FLOOD","VI",0,20000,0,0,20000,0
"5517",10,"FLOOD","VT",0,591000,0,0,591000,0
"5518",10,"FLOOD","WA",0,14600000,0,0,14600000,0
"5519",10,"FLOOD","WI",0,1e+05,0,1,1e+05,1
"5520",10,"FREEZING FOG","TN",0,20000,0,1,20000,1
"5521",10,"FROST/FREEZE","IA",3500000,0,0,0,3500000,0
"5522",10,"FROST/FREEZE","NY",18000,0,0,0,18000,0
"5523",10,"HAIL","AL",9000,2e+05,0,0,209000,0
"5524",10,"HAIL","AR",0,609160,0,0,609160,0
"5525",10,"HAIL","AZ",0,2810107000,1,7,2810107000,8
"5526",10,"HAIL","CA",4500000,2000,0,0,4502000,0
"5527",10,"HAIL","CO",50000,87910000,0,0,87960000,0
"5528",10,"HAIL","FL",0,30000,0,0,30000,0
"5529",10,"HAIL","GA",2500,1185800,0,0,1188300,0
"5530",10,"HAIL","IA",40093000,1512500,0,0,41605500,0
"5531",10,"HAIL","ID",0,30000,0,0,30000,0
"5532",10,"HAIL","IL",30100,76100,0,0,106200,0
"5533",10,"HAIL","IN",0,15000,0,0,15000,0
"5534",10,"HAIL","KS",0,295500,0,0,295500,0
"5535",10,"HAIL","KY",0,10000,0,0,10000,0
"5536",10,"HAIL","MI",250000,412000,0,0,662000,0
"5537",10,"HAIL","MN",45000,41750,0,0,86750,0
"5538",10,"HAIL","MO",0,631210,0,0,631210,0
"5539",10,"HAIL","MS",35000,2014580,0,0,2049580,0
"5540",10,"HAIL","NE",2e+05,133000,0,0,333000,0
"5541",10,"HAIL","NM",255000,53120000,0,0,53375000,0
"5542",10,"HAIL","NY",0,62000,0,0,62000,0
"5543",10,"HAIL","OH",0,201210000,0,2,201210000,2
"5544",10,"HAIL","OK",8e+05,863500,0,0,1663500,0
"5545",10,"HAIL","OR",0,0,0,7,0,7
"5546",10,"HAIL","PA",0,26000,0,0,26000,0
"5547",10,"HAIL","PR",0,0,0,1,0,1
"5548",10,"HAIL","SC",0,13000,0,0,13000,0
"5549",10,"HAIL","SD",0,21000,0,0,21000,0
"5550",10,"HAIL","TN",15000,6083020,0,0,6098020,0
"5551",10,"HAIL","TX",89223000,22045750,0,0,111268750,0
"5552",10,"HAIL","UT",0,5500000,0,0,5500000,0
"5553",10,"HAIL","WI",233000,2397000,0,0,2630000,0
"5554",10,"HEAT","FL",0,0,1,0,0,1
"5555",10,"HEAT","SC",0,0,1,0,0,1
"5556",10,"HEAVY RAIN","AL",0,60000,0,1,60000,1
"5557",10,"HEAVY RAIN","AR",0,1e+05,0,0,1e+05,0
"5558",10,"HEAVY RAIN","AZ",0,50000,0,0,50000,0
"5559",10,"HEAVY RAIN","CA",150000,484000,0,3,634000,3
"5560",10,"HEAVY RAIN","FL",0,1e+05,0,0,1e+05,0
"5561",10,"HEAVY RAIN","GA",0,5000,0,0,5000,0
"5562",10,"HEAVY RAIN","GU",0,20000,0,0,20000,0
"5563",10,"HEAVY RAIN","HI",0,5000,0,0,5000,0
"5564",10,"HEAVY RAIN","IA",0,5000,0,0,5000,0
"5565",10,"HEAVY RAIN","KS",0,150000,0,0,150000,0
"5566",10,"HEAVY RAIN","MD",0,20000,1,1,20000,2
"5567",10,"HEAVY RAIN","MS",0,10000,0,0,10000,0
"5568",10,"HEAVY RAIN","NC",0,2600000,0,0,2600000,0
"5569",10,"HEAVY RAIN","NH",0,6e+05,0,0,6e+05,0
"5570",10,"HEAVY RAIN","NM",0,1e+06,0,0,1e+06,0
"5571",10,"HEAVY RAIN","NY",0,6000,0,3,6000,3
"5572",10,"HEAVY RAIN","OR",0,5e+05,0,0,5e+05,0
"5573",10,"HEAVY RAIN","PR",0,214050,5,0,214050,5
"5574",10,"HEAVY RAIN","SC",0,2124000,0,0,2124000,0
"5575",10,"HEAVY RAIN","TN",0,1e+05,0,0,1e+05,0
"5576",10,"HEAVY RAIN","TX",0,255000,0,0,255000,0
"5577",10,"HEAVY RAIN","VA",3e+06,14000,0,0,3014000,0
"5578",10,"HEAVY RAIN","WA",0,2990000,0,0,2990000,0
"5579",10,"HEAVY SNOW","AK",0,75000,1,0,75000,1
"5580",10,"HEAVY SNOW","CA",0,5000,0,0,5000,0
"5581",10,"HEAVY SNOW","CO",0,0,0,5,0,5
"5582",10,"HEAVY SNOW","CT",0,1.1e+07,0,0,1.1e+07,0
"5583",10,"HEAVY SNOW","IA",65900000,32900000,0,0,98800000,0
"5584",10,"HEAVY SNOW","ID",0,82000,0,0,82000,0
"5585",10,"HEAVY SNOW","KS",0,4510000,0,0,4510000,0
"5586",10,"HEAVY SNOW","MA",0,130000,0,0,130000,0
"5587",10,"HEAVY SNOW","MD",0,175000,0,0,175000,0
"5588",10,"HEAVY SNOW","MI",0,1205000,0,0,1205000,0
"5589",10,"HEAVY SNOW","MN",0,35000,0,0,35000,0
"5590",10,"HEAVY SNOW","MO",0,1500000,0,0,1500000,0
"5591",10,"HEAVY SNOW","MT",0,17000,0,0,17000,0
"5592",10,"HEAVY SNOW","NE",1600000,56500000,0,0,58100000,0
"5593",10,"HEAVY SNOW","NH",0,1e+05,0,0,1e+05,0
"5594",10,"HEAVY SNOW","NM",0,0,1,0,0,1
"5595",10,"HEAVY SNOW","NV",0,10000,0,0,10000,0
"5596",10,"HEAVY SNOW","NY",0,505000,0,0,505000,0
"5597",10,"HEAVY SNOW","OH",0,50000,0,0,50000,0
"5598",10,"HEAVY SNOW","PA",0,82000,0,0,82000,0
"5599",10,"HEAVY SNOW","SD",0,11762000,1,1,11762000,2
"5600",10,"HEAVY SNOW","UT",0,325000,0,0,325000,0
"5601",10,"HEAVY SNOW","VA",0,50000,0,0,50000,0
"5602",10,"HEAVY SNOW","VT",0,10000,0,0,10000,0
"5603",10,"HEAVY SNOW","WV",0,185000,0,0,185000,0
"5604",10,"HIGH SURF","AK",0,500,1,1,500,2
"5605",10,"HIGH SURF","AL",0,3000,0,0,3000,0
"5606",10,"HIGH SURF","CA",0,165000,2,4,165000,6
"5607",10,"HIGH SURF","FL",0,7075000,0,0,7075000,0
"5608",10,"HIGH SURF","HI",0,0,1,1,0,2
"5609",10,"HIGH SURF","ME",0,50000,0,0,50000,0
"5610",10,"HIGH SURF","MI",0,0,1,0,0,1
"5611",10,"HIGH SURF","NY",0,0,2,0,0,2
"5612",10,"HIGH SURF","OR",0,0,2,0,0,2
"5613",10,"HIGH SURF","PR",0,0,2,0,0,2
"5614",10,"HIGH WIND","AK",11000,803000,0,2,814000,2
"5615",10,"HIGH WIND","AL",0,3000,1,0,3000,1
"5616",10,"HIGH WIND","AZ",0,43000,0,0,43000,0
"5617",10,"HIGH WIND","CA",0,393930000,0,90,393930000,90
"5618",10,"HIGH WIND","CO",0,6745500,1,6,6745500,7
"5619",10,"HIGH WIND","CT",0,2221000,1,3,2221000,4
"5620",10,"HIGH WIND","DE",0,5000,0,0,5000,0
"5621",10,"HIGH WIND","FL",2.1e+07,6547000,1,4,27547000,5
"5622",10,"HIGH WIND","GA",15000,5115000,0,0,5130000,0
"5623",10,"HIGH WIND","GU",25000,0,0,0,25000,0
"5624",10,"HIGH WIND","IA",175000,1649330,0,1,1824330,1
"5625",10,"HIGH WIND","ID",0,32500,0,0,32500,0
"5626",10,"HIGH WIND","IL",0,1008000,2,4,1008000,6
"5627",10,"HIGH WIND","IN",0,127000,0,2,127000,2
"5628",10,"HIGH WIND","KS",150000,238600,0,3,388600,3
"5629",10,"HIGH WIND","KY",0,175000,0,0,175000,0
"5630",10,"HIGH WIND","LA",0,122000,1,0,122000,1
"5631",10,"HIGH WIND","MA",0,2188500,2,6,2188500,8
"5632",10,"HIGH WIND","MD",0,76000,0,0,76000,0
"5633",10,"HIGH WIND","ME",0,305000,0,1,305000,1
"5634",10,"HIGH WIND","MI",2000,5106500,0,0,5108500,0
"5635",10,"HIGH WIND","MN",0,209000,0,0,209000,0
"5636",10,"HIGH WIND","MO",0,85000,0,7,85000,7
"5637",10,"HIGH WIND","MS",0,55000,0,0,55000,0
"5638",10,"HIGH WIND","MT",0,1230200,0,0,1230200,0
"5639",10,"HIGH WIND","NC",0,15450000,2,10,15450000,12
"5640",10,"HIGH WIND","ND",4910000,2652000,0,0,7562000,0
"5641",10,"HIGH WIND","NE",545000,1022000,0,2,1567000,2
"5642",10,"HIGH WIND","NH",0,250000,0,3,250000,3
"5643",10,"HIGH WIND","NJ",0,250000,2,2,250000,4
"5644",10,"HIGH WIND","NM",0,77000,0,1,77000,1
"5645",10,"HIGH WIND","NV",0,65000,0,0,65000,0
"5646",10,"HIGH WIND","NY",2e+05,6215000,4,6,6415000,10
"5647",10,"HIGH WIND","OH",2250000,7456003,1,9,9706003,10
"5648",10,"HIGH WIND","OR",0,560800,0,0,560800,0
"5649",10,"HIGH WIND","PA",1500,1507500,0,0,1509000,0
"5650",10,"HIGH WIND","RI",0,278000,0,0,278000,0
"5651",10,"HIGH WIND","SC",50000,789500,0,0,839500,0
"5652",10,"HIGH WIND","SD",0,1043000,0,0,1043000,0
"5653",10,"HIGH WIND","TN",0,2196000,0,0,2196000,0
"5654",10,"HIGH WIND","TX",0,25504000,0,0,25504000,0
"5655",10,"HIGH WIND","UT",0,60000,0,0,60000,0
"5656",10,"HIGH WIND","VA",15000,401000,1,0,416000,1
"5657",10,"HIGH WIND","VI",0,5e+05,0,0,5e+05,0
"5658",10,"HIGH WIND","VT",0,644000,0,0,644000,0
"5659",10,"HIGH WIND","WA",0,5202000,7,0,5202000,7
"5660",10,"HIGH WIND","WI",0,1064000,0,10,1064000,10
"5661",10,"HIGH WIND","WV",0,218000,0,0,218000,0
"5662",10,"HIGH WIND","WY",0,136500,0,0,136500,0
"5663",10,"HURRICANE/TYPHOON","AL",2.4e+07,168175000,2,0,192175000,2
"5664",10,"HURRICANE/TYPHOON","FL",3.43e+08,13632241000,6,10,13975241000,16
"5665",10,"HURRICANE/TYPHOON","GU",1e+05,2e+05,0,3,3e+05,3
"5666",10,"HURRICANE/TYPHOON","LA",1.68e+08,518780000,0,3,686780000,3
"5667",10,"HURRICANE/TYPHOON","MS",0,575010,0,1,575010,1
"5668",10,"HURRICANE/TYPHOON","NC",0,31000,1,0,31000,1
"5669",10,"HURRICANE/TYPHOON","PR",0,20000,0,0,20000,0
"5670",10,"HURRICANE/TYPHOON","VA",0,45000,0,0,45000,0
"5671",10,"HURRICANE/TYPHOON","VI",0,20000,0,0,20000,0
"5672",10,"ICE STORM","AK",0,48000,0,0,48000,0
"5673",10,"ICE STORM","MD",0,250000,0,0,250000,0
"5674",10,"ICE STORM","NM",0,50000,0,0,50000,0
"5675",10,"ICE STORM","PA",0,1e+06,0,0,1e+06,0
"5676",10,"ICE STORM","WV",0,2e+05,0,0,2e+05,0
"5677",10,"LAKE-EFFECT SNOW","NY",0,22858000,0,0,22858000,0
"5678",10,"LAKE-EFFECT SNOW","PA",0,75000,0,0,75000,0
"5679",10,"LAKESHORE FLOOD","PA",0,10000,0,0,10000,0
"5680",10,"LIGHTNING","AL",0,437500,1,10,437500,11
"5681",10,"LIGHTNING","AR",0,433500,0,0,433500,0
"5682",10,"LIGHTNING","AZ",0,35000,1,9,35000,10
"5683",10,"LIGHTNING","CA",0,183500,0,1,183500,1
"5684",10,"LIGHTNING","CO",0,29500,0,5,29500,5
"5685",10,"LIGHTNING","FL",0,489500,2,24,489500,26
"5686",10,"LIGHTNING","GA",0,697000,0,1,697000,1
"5687",10,"LIGHTNING","GU",0,0,1,0,0,1
"5688",10,"LIGHTNING","IA",0,49000,0,0,49000,0
"5689",10,"LIGHTNING","ID",0,50000,0,0,50000,0
"5690",10,"LIGHTNING","IL",0,107000,0,1,107000,1
"5691",10,"LIGHTNING","IN",0,825000,0,0,825000,0
"5692",10,"LIGHTNING","KS",0,87000,0,0,87000,0
"5693",10,"LIGHTNING","KY",0,140000,0,0,140000,0
"5694",10,"LIGHTNING","LA",0,1319000,0,6,1319000,6
"5695",10,"LIGHTNING","MA",0,50000,0,0,50000,0
"5696",10,"LIGHTNING","ME",0,382000,0,0,382000,0
"5697",10,"LIGHTNING","MI",0,358000,0,3,358000,3
"5698",10,"LIGHTNING","MN",0,5000,0,4,5000,4
"5699",10,"LIGHTNING","MO",0,6000,3,15,6000,18
"5700",10,"LIGHTNING","MS",0,52000,0,1,52000,1
"5701",10,"LIGHTNING","MT",0,10000,0,1,10000,1
"5702",10,"LIGHTNING","NC",0,1e+05,0,0,1e+05,0
"5703",10,"LIGHTNING","ND",0,7000,0,0,7000,0
"5704",10,"LIGHTNING","NE",0,269000,0,0,269000,0
"5705",10,"LIGHTNING","NH",0,20000,0,3,20000,3
"5706",10,"LIGHTNING","NJ",0,1e+05,0,0,1e+05,0
"5707",10,"LIGHTNING","NM",0,0,0,1,0,1
"5708",10,"LIGHTNING","NV",0,172000,0,0,172000,0
"5709",10,"LIGHTNING","NY",0,147000,0,4,147000,4
"5710",10,"LIGHTNING","OH",0,115000,0,0,115000,0
"5711",10,"LIGHTNING","OK",0,1347500,0,4,1347500,4
"5712",10,"LIGHTNING","OR",0,0,0,1,0,1
"5713",10,"LIGHTNING","PA",0,21000,1,1,21000,2
"5714",10,"LIGHTNING","PR",0,313000,0,0,313000,0
"5715",10,"LIGHTNING","SD",0,30000,0,0,30000,0
"5716",10,"LIGHTNING","TN",0,2140000,0,1,2140000,1
"5717",10,"LIGHTNING","TX",0,999000,3,8,999000,11
"5718",10,"LIGHTNING","UT",0,126000,2,5,126000,7
"5719",10,"LIGHTNING","VA",0,3e+05,0,0,3e+05,0
"5720",10,"LIGHTNING","VI",0,1000,0,0,1000,0
"5721",10,"LIGHTNING","VT",0,120000,0,0,120000,0
"5722",10,"LIGHTNING","WA",0,112000,0,0,112000,0
"5723",10,"LIGHTNING","WI",15000,8860300,0,2,8875300,2
"5724",10,"MARINE HIGH WIND","LM",0,1e+06,0,0,1e+06,0
"5725",10,"MARINE STRONG WIND","AN",0,0,2,3,0,5
"5726",10,"MARINE STRONG WIND","LM",0,300400,0,1,300400,1
"5727",10,"MARINE THUNDERSTORM WIND","AM",0,1800,0,13,1800,13
"5728",10,"MARINE THUNDERSTORM WIND","GM",0,1000,0,0,1000,0
"5729",10,"OTHER EVENT NON IDENTIFIED","PR",0,50,0,0,50,0
"5730",10,"RIP CURRENT","AL",0,0,1,0,0,1
"5731",10,"RIP CURRENT","CA",0,0,3,13,0,16
"5732",10,"RIP CURRENT","CT",0,0,2,0,0,2
"5733",10,"RIP CURRENT","FL",0,0,18,10,0,28
"5734",10,"RIP CURRENT","GU",0,0,4,10,0,14
"5735",10,"RIP CURRENT","NY",0,0,1,3,0,4
"5736",10,"RIP CURRENT","RI",0,0,0,1,0,1
"5737",10,"STORM SURGE/TIDE","AK",0,21612000,0,0,21612000,0
"5738",10,"STORM SURGE/TIDE","CA",0,1e+06,2,4,1e+06,6
"5739",10,"STORM SURGE/TIDE","LA",0,1e+05,0,0,1e+05,0
"5740",10,"STORM SURGE/TIDE","ME",0,525000,0,0,525000,0
"5741",10,"STORM SURGE/TIDE","MS",0,30000,0,0,30000,0
"5742",10,"STORM SURGE/TIDE","NC",0,10000,0,0,10000,0
"5743",10,"STORM SURGE/TIDE","NH",0,150000,0,0,150000,0
"5744",10,"STRONG WIND","AK",0,15000,0,0,15000,0
"5745",10,"STRONG WIND","AL",1000,5000,0,0,6000,0
"5746",10,"STRONG WIND","AR",0,212300,1,2,212300,3
"5747",10,"STRONG WIND","AZ",0,17000,0,0,17000,0
"5748",10,"STRONG WIND","CA",0,416400,0,6,416400,6
"5749",10,"STRONG WIND","CO",5000,27000,0,0,32000,0
"5750",10,"STRONG WIND","CT",0,415200,0,3,415200,3
"5751",10,"STRONG WIND","DC",0,70000,0,0,70000,0
"5752",10,"STRONG WIND","DE",0,85500,0,0,85500,0
"5753",10,"STRONG WIND","FL",0,29500,0,0,29500,0
"5754",10,"STRONG WIND","GA",0,48500,0,0,48500,0
"5755",10,"STRONG WIND","HI",0,0,0,4,0,4
"5756",10,"STRONG WIND","IA",0,3000,0,0,3000,0
"5757",10,"STRONG WIND","ID",0,6000,0,0,6000,0
"5758",10,"STRONG WIND","IL",0,35000,0,2,35000,2
"5759",10,"STRONG WIND","IN",0,15000,2,0,15000,2
"5760",10,"STRONG WIND","KS",0,0,0,1,0,1
"5761",10,"STRONG WIND","KY",0,123000,0,0,123000,0
"5762",10,"STRONG WIND","LA",0,6000,0,0,6000,0
"5763",10,"STRONG WIND","MA",0,535000,0,2,535000,2
"5764",10,"STRONG WIND","MD",0,174500,0,0,174500,0
"5765",10,"STRONG WIND","ME",0,1605000,1,0,1605000,1
"5766",10,"STRONG WIND","MI",0,13500,2,0,13500,2
"5767",10,"STRONG WIND","MN",0,13000,0,0,13000,0
"5768",10,"STRONG WIND","MO",0,1000,0,0,1000,0
"5769",10,"STRONG WIND","MS",0,11900,0,0,11900,0
"5770",10,"STRONG WIND","MT",0,61000,0,0,61000,0
"5771",10,"STRONG WIND","NC",0,2000,0,0,2000,0
"5772",10,"STRONG WIND","NE",6e+05,37000,0,1,637000,1
"5773",10,"STRONG WIND","NH",0,155000,1,5,155000,6
"5774",10,"STRONG WIND","NJ",0,912000,1,2,912000,3
"5775",10,"STRONG WIND","NV",0,3500,0,0,3500,0
"5776",10,"STRONG WIND","NY",0,298000,0,2,298000,2
"5777",10,"STRONG WIND","OH",0,290000,0,0,290000,0
"5778",10,"STRONG WIND","OR",0,101000,0,0,101000,0
"5779",10,"STRONG WIND","PA",0,670000,0,0,670000,0
"5780",10,"STRONG WIND","PR",0,25000,0,0,25000,0
"5781",10,"STRONG WIND","RI",0,8500,0,0,8500,0
"5782",10,"STRONG WIND","SC",0,105000,0,0,105000,0
"5783",10,"STRONG WIND","TN",0,78000,0,0,78000,0
"5784",10,"STRONG WIND","TX",5e+05,95100,0,0,595100,0
"5785",10,"STRONG WIND","UT",0,1000,0,0,1000,0
"5786",10,"STRONG WIND","VA",0,216000,0,0,216000,0
"5787",10,"STRONG WIND","VT",0,34000,0,0,34000,0
"5788",10,"STRONG WIND","WA",0,532000,0,1,532000,1
"5789",10,"STRONG WIND","WI",0,140000,0,1,140000,1
"5790",10,"STRONG WIND","WV",0,61000,0,0,61000,0
"5791",10,"THUNDERSTORM WIND","AL",1000,2038050,0,11,2039050,11
"5792",10,"THUNDERSTORM WIND","AR",0,6294000,0,13,6294000,13
"5793",10,"THUNDERSTORM WIND","AZ",0,780000,0,5,780000,5
"5794",10,"THUNDERSTORM WIND","CA",0,817000,0,0,817000,0
"5795",10,"THUNDERSTORM WIND","CO",0,29500,1,0,29500,1
"5796",10,"THUNDERSTORM WIND","CT",0,22000,0,0,22000,0
"5797",10,"THUNDERSTORM WIND","DC",0,0,0,1,0,1
"5798",10,"THUNDERSTORM WIND","FL",500,3182950,0,3,3183450,3
"5799",10,"THUNDERSTORM WIND","GA",50550500,88559100,8,19,139109600,27
"5800",10,"THUNDERSTORM WIND","IA",124800,1505000,0,2,1629800,2
"5801",10,"THUNDERSTORM WIND","ID",0,5e+05,0,0,5e+05,0
"5802",10,"THUNDERSTORM WIND","IL",355000,5084000,1,19,5439000,20
"5803",10,"THUNDERSTORM WIND","IN",505000,2753000,0,13,3258000,13
"5804",10,"THUNDERSTORM WIND","KS",1e+05,5501100,4,15,5601100,19
"5805",10,"THUNDERSTORM WIND","KY",10000,2803000,0,6,2813000,6
"5806",10,"THUNDERSTORM WIND","LA",0,4149100,1,11,4149100,12
"5807",10,"THUNDERSTORM WIND","MA",0,10000,0,0,10000,0
"5808",10,"THUNDERSTORM WIND","MD",0,29450,1,1,29450,2
"5809",10,"THUNDERSTORM WIND","MI",3223000,5567000,1,10,8790000,11
"5810",10,"THUNDERSTORM WIND","MN",0,1775500,0,3,1775500,3
"5811",10,"THUNDERSTORM WIND","MO",0,2816500,0,6,2816500,6
"5812",10,"THUNDERSTORM WIND","MS",0,7922750,0,5,7922750,5
"5813",10,"THUNDERSTORM WIND","NC",25000,503500,0,5,528500,5
"5814",10,"THUNDERSTORM WIND","ND",0,216000,0,0,216000,0
"5815",10,"THUNDERSTORM WIND","NE",350000,3433500,0,3,3783500,3
"5816",10,"THUNDERSTORM WIND","NJ",1e+05,555000,0,29,655000,29
"5817",10,"THUNDERSTORM WIND","NM",1000,366000,0,2,367000,2
"5818",10,"THUNDERSTORM WIND","NV",0,2000,0,0,2000,0
"5819",10,"THUNDERSTORM WIND","NY",0,504000,1,10,504000,11
"5820",10,"THUNDERSTORM WIND","OH",3000,12682000,1,9,12685000,10
"5821",10,"THUNDERSTORM WIND","OK",0,5239650,1,66,5239650,67
"5822",10,"THUNDERSTORM WIND","PA",0,2094000,1,7,2094000,8
"5823",10,"THUNDERSTORM WIND","PR",0,6550,0,0,6550,0
"5824",10,"THUNDERSTORM WIND","SC",0,248330,0,2,248330,2
"5825",10,"THUNDERSTORM WIND","SD",0,824000,0,0,824000,0
"5826",10,"THUNDERSTORM WIND","TN",455000,3783700,1,10,4238700,11
"5827",10,"THUNDERSTORM WIND","TX",2385000,18336860,0,22,20721860,22
"5828",10,"THUNDERSTORM WIND","VA",0,297200,0,2,297200,2
"5829",10,"THUNDERSTORM WIND","WA",0,30000,0,0,30000,0
"5830",10,"THUNDERSTORM WIND","WI",0,718750,0,0,718750,0
"5831",10,"THUNDERSTORM WIND","WV",0,571400,0,10,571400,10
"5832",10,"THUNDERSTORM WIND","WY",0,287500,0,0,287500,0
"5833",10,"TORNADO","AL",0,16750000,0,19,16750000,19
"5834",10,"TORNADO","AR",2000,26793000,2,45,26795000,47
"5835",10,"TORNADO","AZ",0,1970530,0,10,1970530,10
"5836",10,"TORNADO","CA",1000,50030,0,6,51030,6
"5837",10,"TORNADO","CO",2000,3143530,0,15,3145530,15
"5838",10,"TORNADO","CT",0,250030000,3,501,250030000,504
"5839",10,"TORNADO","DE",0,252750,0,0,252750,0
"5840",10,"TORNADO","FL",10000,80682620,7,268,80692620,275
"5841",10,"TORNADO","GA",425000,62134250,6,51,62559250,57
"5842",10,"TORNADO","IA",20000,30130110,6,174,30150110,180
"5843",10,"TORNADO","ID",0,51000,0,0,51000,0
"5844",10,"TORNADO","IL",0,19106000,1,35,19106000,36
"5845",10,"TORNADO","IN",10000,34563780,5,41,34573780,46
"5846",10,"TORNADO","KS",0,13636250,1,51,13636250,52
"5847",10,"TORNADO","KY",250000,18542000,0,35,18792000,35
"5848",10,"TORNADO","LA",0,89019000,29,344,89019000,373
"5849",10,"TORNADO","MA",0,532500,1,0,532500,1
"5850",10,"TORNADO","MD",0,33711000,0,63,33711000,63
"5851",10,"TORNADO","ME",0,305750,0,0,305750,0
"5852",10,"TORNADO","MI",0,31770450,3,21,31770450,24
"5853",10,"TORNADO","MN",0,1310000,0,12,1310000,12
"5854",10,"TORNADO","MO",0,36591780,8,84,36591780,92
"5855",10,"TORNADO","MS",50000,34505750,5,66,34555750,71
"5856",10,"TORNADO","MT",0,250,0,0,250,0
"5857",10,"TORNADO","NC",10000,26155000,1,24,26165000,25
"5858",10,"TORNADO","ND",0,5000,0,0,5000,0
"5859",10,"TORNADO","NE",3235700,17172500,0,11,20408200,11
"5860",10,"TORNADO","NH",0,50000,0,0,50000,0
"5861",10,"TORNADO","NJ",0,5525000,1,19,5525000,20
"5862",10,"TORNADO","NM",0,562090,1,8,562090,9
"5863",10,"TORNADO","NV",0,25000,0,0,25000,0
"5864",10,"TORNADO","NY",0,1315000,2,10,1315000,12
"5865",10,"TORNADO","OH",25000,62299500,0,31,62324500,31
"5866",10,"TORNADO","OK",0,188091360,7,122,188091360,129
"5867",10,"TORNADO","OR",0,165000,0,0,165000,0
"5868",10,"TORNADO","PA",0,10605000,0,15,10605000,15
"5869",10,"TORNADO","PR",0,5000,0,0,5000,0
"5870",10,"TORNADO","RI",0,250000,0,0,250000,0
"5871",10,"TORNADO","SC",0,4531750,1,20,4531750,21
"5872",10,"TORNADO","SD",0,325000,0,0,325000,0
"5873",10,"TORNADO","TN",0,12376000,1,24,12376000,25
"5874",10,"TORNADO","TX",222000,225420550,7,237,225642550,244
"5875",10,"TORNADO","VA",10000,18917780,1,10,18927780,11
"5876",10,"TORNADO","VT",0,25000,0,0,25000,0
"5877",10,"TORNADO","WA",0,81000,0,0,81000,0
"5878",10,"TORNADO","WI",0,3052530,0,8,3052530,8
"5879",10,"TORNADO","WV",0,830000,0,2,830000,2
"5880",10,"TORNADO","WY",0,250,0,0,250,0
"5881",10,"TROPICAL STORM","FL",66500000,60700000,0,1,127200000,1
"5882",10,"TROPICAL STORM","GU",50000,255000,0,0,305000,0
"5883",10,"TROPICAL STORM","LA",0,50000,0,0,50000,0
"5884",10,"TROPICAL STORM","MD",0,1e+05,0,0,1e+05,0
"5885",10,"TROPICAL STORM","MS",0,13380000,0,0,13380000,0
"5886",10,"TROPICAL STORM","NC",0,1e+05,0,0,1e+05,0
"5887",10,"WATERSPOUT","AM",0,5002000,0,0,5002000,0
"5888",10,"WATERSPOUT","FL",0,150500,0,0,150500,0
"5889",10,"WATERSPOUT","GM",0,30000,0,0,30000,0
"5890",10,"WILDFIRE","AR",0,1e+05,0,0,1e+05,0
"5891",10,"WILDFIRE","AZ",0,2500000,0,0,2500000,0
"5892",10,"WILDFIRE","CA",121697000,2366264770,29,374,2487961770,403
"5893",10,"WILDFIRE","CO",20000,35000,0,0,55000,0
"5894",10,"WILDFIRE","GA",0,19500,0,0,19500,0
"5895",10,"WILDFIRE","KS",0,5000,0,0,5000,0
"5896",10,"WILDFIRE","LA",2e+06,1e+05,0,1,2100000,1
"5897",10,"WILDFIRE","MN",3000,27500,0,0,30500,0
"5898",10,"WILDFIRE","MT",0,1.1e+07,0,0,1.1e+07,0
"5899",10,"WILDFIRE","NE",5e+06,1e+06,0,0,6e+06,0
"5900",10,"WILDFIRE","OR",2e+05,58000,0,0,258000,0
"5901",10,"WILDFIRE","TX",0,16700,0,0,16700,0
"5902",10,"WILDFIRE","VA",6000,0,0,0,6000,0
"5903",10,"WILDFIRE","WA",10000,0,0,0,10000,0
"5904",10,"WINTER STORM","CA",0,0,2,0,0,2
"5905",10,"WINTER STORM","CO",0,5000,1,0,5000,1
"5906",10,"WINTER STORM","KS",5e+05,3e+06,0,0,3500000,0
"5907",10,"WINTER STORM","MA",0,50000,0,0,50000,0
"5908",10,"WINTER STORM","MD",0,250000,0,1,250000,1
"5909",10,"WINTER STORM","MT",0,5e+05,0,0,5e+05,0
"5910",10,"WINTER STORM","ND",0,0,0,2,0,2
"5911",10,"WINTER STORM","NE",4720000,15258000,0,0,19978000,0
"5912",10,"WINTER STORM","NM",0,250000,0,0,250000,0
"5913",10,"WINTER STORM","NY",0,275000,0,0,275000,0
"5914",10,"WINTER STORM","SD",0,1780000,0,0,1780000,0
"5915",10,"WINTER STORM","TX",0,2e+05,0,0,2e+05,0
"5916",10,"WINTER STORM","UT",0,1165000,0,23,1165000,23
"5917",10,"WINTER STORM","VT",0,865000,0,0,865000,0
"5918",10,"WINTER STORM","WV",0,80000,0,0,80000,0
"5919",10,"WINTER STORM","WY",0,1745000,3,30,1745000,33
"5920",10,"WINTER WEATHER","AZ",0,4e+05,0,0,4e+05,0
"5921",10,"WINTER WEATHER","CA",0,10000,3,0,10000,3
"5922",10,"WINTER WEATHER","CO",0,13000,0,0,13000,0
"5923",10,"WINTER WEATHER","ID",0,0,1,1,0,2
"5924",10,"WINTER WEATHER","KS",0,170000,0,0,170000,0
"5925",10,"WINTER WEATHER","MA",0,5000,0,0,5000,0
"5926",10,"WINTER WEATHER","ND",0,15000,0,0,15000,0
"5927",10,"WINTER WEATHER","NE",0,6000,0,0,6000,0
"5928",10,"WINTER WEATHER","NV",0,5000,0,0,5000,0
"5929",10,"WINTER WEATHER","NY",0,70000,0,0,70000,0
"5930",10,"WINTER WEATHER","VT",0,175000,0,0,175000,0
"5931",10,"WINTER WEATHER","WV",0,60000,0,0,60000,0
"5932",11,"AVALANCHE","AK",0,0,1,1,0,2
"5933",11,"AVALANCHE","CO",0,500,2,3,500,5
"5934",11,"AVALANCHE","MT",0,0,2,0,0,2
"5935",11,"AVALANCHE","UT",0,0,3,1,0,4
"5936",11,"BLIZZARD","AK",0,1000,0,0,1000,0
"5937",11,"BLIZZARD","CO",0,10000,0,0,10000,0
"5938",11,"BLIZZARD","IA",0,250030,0,0,250030,0
"5939",11,"BLIZZARD","ID",0,25000,0,0,25000,0
"5940",11,"BLIZZARD","KS",0,3e+05,0,0,3e+05,0
"5941",11,"BLIZZARD","MI",0,35000,0,0,35000,0
"5942",11,"BLIZZARD","MN",0,240000,0,0,240000,0
"5943",11,"BLIZZARD","ND",0,50000,0,0,50000,0
"5944",11,"BLIZZARD","NE",0,10950000,0,0,10950000,0
"5945",11,"BLIZZARD","OR",0,1e+05,0,0,1e+05,0
"5946",11,"BLIZZARD","SD",0,2399920,1,2,2399920,3
"5947",11,"BLIZZARD","WY",0,787000,0,0,787000,0
"5948",11,"COASTAL FLOOD","AK",0,25025000,1,0,25025000,1
"5949",11,"COASTAL FLOOD","DE",0,40000500,0,0,40000500,0
"5950",11,"COASTAL FLOOD","FL",0,70000,0,0,70000,0
"5951",11,"COASTAL FLOOD","LA",0,1e+05,0,0,1e+05,0
"5952",11,"COASTAL FLOOD","MA",0,11000,0,0,11000,0
"5953",11,"COASTAL FLOOD","MD",0,116000,0,0,116000,0
"5954",11,"COASTAL FLOOD","ME",0,12500,0,0,12500,0
"5955",11,"COASTAL FLOOD","NC",0,12987000,0,0,12987000,0
"5956",11,"COASTAL FLOOD","NH",0,5000,0,0,5000,0
"5957",11,"COASTAL FLOOD","PR",0,35000,2,0,35000,2
"5958",11,"COASTAL FLOOD","TX",0,7e+05,0,0,7e+05,0
"5959",11,"COASTAL FLOOD","VA",0,1705000,0,0,1705000,0
"5960",11,"COLD/WIND CHILL","MI",0,0,1,0,0,1
"5961",11,"COLD/WIND CHILL","NM",0,0,1,0,0,1
"5962",11,"COLD/WIND CHILL","OK",0,0,1,0,0,1
"5963",11,"COLD/WIND CHILL","OR",60000,0,0,0,60000,0
"5964",11,"COLD/WIND CHILL","SC",0,0,1,0,0,1
"5965",11,"COLD/WIND CHILL","TX",0,0,1,0,0,1
"5966",11,"COLD/WIND CHILL","WA",65050000,0,0,0,65050000,0
"5967",11,"COLD/WIND CHILL","WI",0,0,3,0,0,3
"5968",11,"DEBRIS FLOW","AK",0,4e+05,0,0,4e+05,0
"5969",11,"DEBRIS FLOW","AL",0,20000,0,0,20000,0
"5970",11,"DEBRIS FLOW","CA",0,160000,0,0,160000,0
"5971",11,"DEBRIS FLOW","CO",0,1405000,0,0,1405000,0
"5972",11,"DEBRIS FLOW","FL",0,1e+05,0,0,1e+05,0
"5973",11,"DEBRIS FLOW","OR",0,0,0,2,0,2
"5974",11,"DEBRIS FLOW","PR",0,120000,0,0,120000,0
"5975",11,"DEBRIS FLOW","WA",0,1410000,0,0,1410000,0
"5976",11,"DENSE FOG","AL",0,530000,0,20,530000,20
"5977",11,"DENSE FOG","CA",0,3090000,2,208,3090000,210
"5978",11,"DENSE FOG","FL",0,1e+05,2,7,1e+05,9
"5979",11,"DENSE FOG","IN",0,0,1,0,0,1
"5980",11,"DENSE FOG","KS",0,5000,0,0,5000,0
"5981",11,"DENSE FOG","NC",0,6000,0,2,6000,2
"5982",11,"DENSE FOG","NM",0,5000,0,0,5000,0
"5983",11,"DENSE FOG","OH",0,12000,2,3,12000,5
"5984",11,"DENSE FOG","OK",0,60000,0,0,60000,0
"5985",11,"DENSE FOG","OR",0,30000,0,2,30000,2
"5986",11,"DENSE FOG","SC",0,15000,1,10,15000,11
"5987",11,"DENSE FOG","TX",0,105000,0,0,105000,0
"5988",11,"DENSE FOG","UT",0,20000,1,2,20000,3
"5989",11,"DENSE SMOKE","OR",0,1e+05,0,0,1e+05,0
"5990",11,"DROUGHT","GA",25000,0,0,0,25000,0
"5991",11,"DROUGHT","MD",26040000,0,0,0,26040000,0
"5992",11,"DROUGHT","NC",225000,0,0,0,225000,0
"5993",11,"DROUGHT","NE",0,55000,0,0,55000,0
"5994",11,"DROUGHT","OK",2e+06,0,0,0,2e+06,0
"5995",11,"DROUGHT","TX",650849000,8002000,0,0,658851000,0
"5996",11,"DROUGHT","VA",20550000,0,0,0,20550000,0
"5997",11,"DROUGHT","WV",36000,0,0,0,36000,0
"5998",11,"DUST STORM","AZ",0,1e+05,0,0,1e+05,0
"5999",11,"DUST STORM","CA",0,75000,0,46,75000,46
"6000",11,"DUST STORM","ID",0,5000,0,0,5000,0
"6001",11,"DUST STORM","NV",0,50000,0,0,50000,0
"6002",11,"DUST STORM","WA",0,0,0,1,0,1
"6003",11,"EXTREME COLD/WIND CHILL","CA",0,0,0,4,0,4
"6004",11,"EXTREME COLD/WIND CHILL","ND",0,0,1,0,0,1
"6005",11,"EXTREME COLD/WIND CHILL","PA",0,0,1,0,0,1
"6006",11,"FLASH FLOOD","AL",0,1014000,1,0,1014000,1
"6007",11,"FLASH FLOOD","AR",0,4535500,0,0,4535500,0
"6008",11,"FLASH FLOOD","AZ",0,50000,0,0,50000,0
"6009",11,"FLASH FLOOD","CA",0,765000,1,0,765000,1
"6010",11,"FLASH FLOOD","CT",0,5000,0,0,5000,0
"6011",11,"FLASH FLOOD","DC",0,5000,0,0,5000,0
"6012",11,"FLASH FLOOD","DE",0,5000,0,0,5000,0
"6013",11,"FLASH FLOOD","FL",0,531000,0,0,531000,0
"6014",11,"FLASH FLOOD","GA",0,67000,0,0,67000,0
"6015",11,"FLASH FLOOD","HI",205000,70700000,0,0,70905000,0
"6016",11,"FLASH FLOOD","IA",0,50000,0,0,50000,0
"6017",11,"FLASH FLOOD","IL",0,1941000,0,0,1941000,0
"6018",11,"FLASH FLOOD","IN",10000,950000,0,0,960000,0
"6019",11,"FLASH FLOOD","KS",105000,9540000,0,0,9645000,0
"6020",11,"FLASH FLOOD","KY",6000,18204000,0,0,18210000,0
"6021",11,"FLASH FLOOD","LA",0,725500,0,0,725500,0
"6022",11,"FLASH FLOOD","MD",0,0,4,0,0,4
"6023",11,"FLASH FLOOD","MO",150000,40035000,9,1,40185000,10
"6024",11,"FLASH FLOOD","MS",0,1025000,0,0,1025000,0
"6025",11,"FLASH FLOOD","MT",0,7011600,0,0,7011600,0
"6026",11,"FLASH FLOOD","NC",0,1615000,0,0,1615000,0
"6027",11,"FLASH FLOOD","NV",0,0,1,1,0,2
"6028",11,"FLASH FLOOD","NY",0,53692000,0,5,53692000,5
"6029",11,"FLASH FLOOD","OH",0,1395000,0,0,1395000,0
"6030",11,"FLASH FLOOD","OK",0,193000,1,0,193000,1
"6031",11,"FLASH FLOOD","OR",0,10000,0,0,10000,0
"6032",11,"FLASH FLOOD","PA",0,4021500,1,7,4021500,8
"6033",11,"FLASH FLOOD","PR",0,1574000,8,1,1574000,9
"6034",11,"FLASH FLOOD","TN",4000,354000,0,0,358000,0
"6035",11,"FLASH FLOOD","TX",255000,17568000,22,193,17823000,215
"6036",11,"FLASH FLOOD","UT",0,5065000,0,2,5065000,2
"6037",11,"FLASH FLOOD","VA",0,4438000,0,0,4438000,0
"6038",11,"FLASH FLOOD","VI",0,1700000,0,0,1700000,0
"6039",11,"FLASH FLOOD","WI",0,10000,0,0,10000,0
"6040",11,"FLASH FLOOD","WV",0,2748000,0,0,2748000,0
"6041",11,"FLOOD","AK",0,105000,0,0,105000,0
"6042",11,"FLOOD","AL",0,15000,0,0,15000,0
"6043",11,"FLOOD","AR",15110000,210000,0,1,15320000,1
"6044",11,"FLOOD","CA",0,1093000,0,3,1093000,3
"6045",11,"FLOOD","FL",0,4310000,0,0,4310000,0
"6046",11,"FLOOD","GA",0,57100,0,0,57100,0
"6047",11,"FLOOD","GU",0,5000,0,0,5000,0
"6048",11,"FLOOD","IA",5000,30000,0,0,35000,0
"6049",11,"FLOOD","ID",0,2e+06,0,0,2e+06,0
"6050",11,"FLOOD","IN",5e+05,5006750,0,0,5506750,0
"6051",11,"FLOOD","KS",0,31950200,1,2,31950200,3
"6052",11,"FLOOD","KY",10000,464000,0,0,474000,0
"6053",11,"FLOOD","LA",0,2385000,0,0,2385000,0
"6054",11,"FLOOD","MD",0,5055000,0,0,5055000,0
"6055",11,"FLOOD","ME",0,450000,0,0,450000,0
"6056",11,"FLOOD","MO",50000,50040000,0,0,50090000,0
"6057",11,"FLOOD","MS",0,955000,1,0,955000,1
"6058",11,"FLOOD","MT",0,60000,0,0,60000,0
"6059",11,"FLOOD","NC",0,50000,0,0,50000,0
"6060",11,"FLOOD","NH",0,852000,0,0,852000,0
"6061",11,"FLOOD","NY",0,2529000,0,0,2529000,0
"6062",11,"FLOOD","OH",0,672000,0,0,672000,0
"6063",11,"FLOOD","OR",4e+05,103210500,5,6,103610500,11
"6064",11,"FLOOD","PA",0,285000,0,0,285000,0
"6065",11,"FLOOD","PR",4.8e+07,86696500,4,2,134696500,6
"6066",11,"FLOOD","TN",8000,1399000,1,0,1407000,1
"6067",11,"FLOOD","TX",0,2403000,0,0,2403000,0
"6068",11,"FLOOD","VA",0,13661000,3,0,13661000,3
"6069",11,"FLOOD","VI",0,1500000,0,0,1500000,0
"6070",11,"FLOOD","VT",0,65000,0,0,65000,0
"6071",11,"FLOOD","WA",0,29504000,2,0,29504000,2
"6072",11,"FLOOD","WV",0,26460000,3,0,26460000,3
"6073",11,"FREEZING FOG","ND",0,35000,3,13,35000,16
"6074",11,"FREEZING FOG","NM",0,0,1,1,0,2
"6075",11,"FREEZING FOG","TN",0,20000,0,1,20000,1
"6076",11,"FROST/FREEZE","IA",0,5000,0,0,5000,0
"6077",11,"FROST/FREEZE","KS",0,15000,0,0,15000,0
"6078",11,"FROST/FREEZE","ND",0,15000,1,3,15000,4
"6079",11,"FROST/FREEZE","VA",0,9000,0,0,9000,0
"6080",11,"HAIL","AL",2000,117500,0,0,119500,0
"6081",11,"HAIL","AR",0,26130,0,0,26130,0
"6082",11,"HAIL","CA",0,3601000,0,0,3601000,0
"6083",11,"HAIL","FL",0,1000,0,0,1000,0
"6084",11,"HAIL","GA",0,101000,0,0,101000,0
"6085",11,"HAIL","IA",0,96000,0,0,96000,0
"6086",11,"HAIL","IL",0,111500,0,0,111500,0
"6087",11,"HAIL","KY",0,553000,0,0,553000,0
"6088",11,"HAIL","LA",0,20500,0,0,20500,0
"6089",11,"HAIL","MD",0,8500,0,0,8500,0
"6090",11,"HAIL","MI",25000,30000,0,0,55000,0
"6091",11,"HAIL","MN",0,950,0,0,950,0
"6092",11,"HAIL","MO",0,6062160,0,0,6062160,0
"6093",11,"HAIL","MS",0,358580,0,0,358580,0
"6094",11,"HAIL","NC",0,2000,0,0,2000,0
"6095",11,"HAIL","NE",0,15000,0,0,15000,0
"6096",11,"HAIL","NY",0,55000,0,0,55000,0
"6097",11,"HAIL","OH",0,488000,0,0,488000,0
"6098",11,"HAIL","OK",0,60033000,0,0,60033000,0
"6099",11,"HAIL","SC",0,2000,0,0,2000,0
"6100",11,"HAIL","SD",0,1000,0,0,1000,0
"6101",11,"HAIL","TN",0,38010,0,0,38010,0
"6102",11,"HAIL","TX",4012000,4919500,0,0,8931500,0
"6103",11,"HAIL","VA",0,3000,0,0,3000,0
"6104",11,"HAIL","WV",0,5000,0,0,5000,0
"6105",11,"HEAT","FL",0,0,0,1,0,1
"6106",11,"HEAVY RAIN","AK",0,3855000,0,0,3855000,0
"6107",11,"HEAVY RAIN","AL",0,5000,0,0,5000,0
"6108",11,"HEAVY RAIN","AZ",0,15000,0,0,15000,0
"6109",11,"HEAVY RAIN","CA",0,150000,2,5,150000,7
"6110",11,"HEAVY RAIN","CT",0,11500,0,0,11500,0
"6111",11,"HEAVY RAIN","FL",2e+05,150000,0,1,350000,1
"6112",11,"HEAVY RAIN","GA",0,125000,0,0,125000,0
"6113",11,"HEAVY RAIN","HI",1500000,13510000,2,0,15010000,2
"6114",11,"HEAVY RAIN","KS",4000,13000,0,0,17000,0
"6115",11,"HEAVY RAIN","LA",0,40000,0,0,40000,0
"6116",11,"HEAVY RAIN","NC",0,1000,0,1,1000,1
"6117",11,"HEAVY RAIN","NV",0,10000,0,2,10000,2
"6118",11,"HEAVY RAIN","NY",0,90000,0,0,90000,0
"6119",11,"HEAVY RAIN","PR",0,652000,0,0,652000,0
"6120",11,"HEAVY RAIN","TX",0,1000,1,0,1000,1
"6121",11,"HEAVY RAIN","VI",0,5e+05,0,0,5e+05,0
"6122",11,"HEAVY RAIN","VT",0,115000,0,0,115000,0
"6123",11,"HEAVY RAIN","WA",0,52895000,1,1,52895000,2
"6124",11,"HEAVY SNOW","AK",0,130000,0,12,130000,12
"6125",11,"HEAVY SNOW","CA",0,330000,3,2,330000,5
"6126",11,"HEAVY SNOW","CO",0,50,1,0,50,1
"6127",11,"HEAVY SNOW","IA",0,930000,0,0,930000,0
"6128",11,"HEAVY SNOW","ID",0,6077000,2,6,6077000,8
"6129",11,"HEAVY SNOW","IL",0,15000,0,0,15000,0
"6130",11,"HEAVY SNOW","KS",0,3223000,0,0,3223000,0
"6131",11,"HEAVY SNOW","MA",0,30000,0,21,30000,21
"6132",11,"HEAVY SNOW","MD",0,231000,0,0,231000,0
"6133",11,"HEAVY SNOW","MN",0,75000,0,0,75000,0
"6134",11,"HEAVY SNOW","MO",0,6000,0,0,6000,0
"6135",11,"HEAVY SNOW","MT",0,1005000,0,3,1005000,3
"6136",11,"HEAVY SNOW","ND",0,625000,1,0,625000,1
"6137",11,"HEAVY SNOW","NM",0,20000,0,0,20000,0
"6138",11,"HEAVY SNOW","NY",0,50676000,0,0,50676000,0
"6139",11,"HEAVY SNOW","OH",0,23680000,0,13,23680000,13
"6140",11,"HEAVY SNOW","OR",0,150000,0,2,150000,2
"6141",11,"HEAVY SNOW","PA",0,6110000,1,2,6110000,3
"6142",11,"HEAVY SNOW","SD",0,194000,0,0,194000,0
"6143",11,"HEAVY SNOW","TX",220000,1810000,0,0,2030000,0
"6144",11,"HEAVY SNOW","UT",0,8e+05,0,40,8e+05,40
"6145",11,"HEAVY SNOW","VA",0,412000,0,0,412000,0
"6146",11,"HEAVY SNOW","VT",0,560000,0,0,560000,0
"6147",11,"HEAVY SNOW","WA",0,5920000,2,22,5920000,24
"6148",11,"HEAVY SNOW","WI",0,65000,0,3,65000,3
"6149",11,"HEAVY SNOW","WV",0,140000,0,0,140000,0
"6150",11,"HEAVY SNOW","WY",0,8000,1,2,8000,3
"6151",11,"HIGH SURF","AL",0,8e+06,0,0,8e+06,0
"6152",11,"HIGH SURF","CA",0,105000,5,11,105000,16
"6153",11,"HIGH SURF","FL",0,5000,3,0,5000,3
"6154",11,"HIGH SURF","HI",0,0,1,5,0,6
"6155",11,"HIGH SURF","ME",0,24000,0,0,24000,0
"6156",11,"HIGH SURF","NC",0,0,1,0,0,1
"6157",11,"HIGH SURF","NY",0,8200000,1,0,8200000,1
"6158",11,"HIGH SURF","OR",0,0,4,1,0,5
"6159",11,"HIGH SURF","PR",0,150000,1,1,150000,2
"6160",11,"HIGH WIND","AK",111000,1655600,0,4,1766600,4
"6161",11,"HIGH WIND","AL",1000,195000,0,0,196000,0
"6162",11,"HIGH WIND","AR",0,35000,0,0,35000,0
"6163",11,"HIGH WIND","AZ",0,1e+05,0,0,1e+05,0
"6164",11,"HIGH WIND","CA",0,20754500,1,15,20754500,16
"6165",11,"HIGH WIND","CO",0,791500,0,10,791500,10
"6166",11,"HIGH WIND","CT",0,1722000,0,1,1722000,1
"6167",11,"HIGH WIND","DC",0,1e+05,0,0,1e+05,0
"6168",11,"HIGH WIND","DE",0,610000,0,1,610000,1
"6169",11,"HIGH WIND","FL",0,73000,0,2,73000,2
"6170",11,"HIGH WIND","GA",0,32500,0,0,32500,0
"6171",11,"HIGH WIND","IA",260100,24367000,1,4,24627100,5
"6172",11,"HIGH WIND","ID",0,1552500,0,3,1552500,3
"6173",11,"HIGH WIND","IL",0,383000,0,7,383000,7
"6174",11,"HIGH WIND","IN",0,253000,0,2,253000,2
"6175",11,"HIGH WIND","KS",10000,313000,0,1,323000,1
"6176",11,"HIGH WIND","KY",0,178000,3,7,178000,10
"6177",11,"HIGH WIND","LA",0,2500,0,0,2500,0
"6178",11,"HIGH WIND","MA",0,2223500,0,2,2223500,2
"6179",11,"HIGH WIND","MD",0,839000,0,0,839000,0
"6180",11,"HIGH WIND","ME",0,5e+05,0,4,5e+05,4
"6181",11,"HIGH WIND","MI",1e+07,29350000,1,1,39350000,2
"6182",11,"HIGH WIND","MN",0,695000,0,3,695000,3
"6183",11,"HIGH WIND","MO",0,102400,0,0,102400,0
"6184",11,"HIGH WIND","MS",0,69000,1,1,69000,2
"6185",11,"HIGH WIND","MT",5e+05,1943000,0,4,2443000,4
"6186",11,"HIGH WIND","NC",0,360000,0,0,360000,0
"6187",11,"HIGH WIND","ND",0,1092000,0,0,1092000,0
"6188",11,"HIGH WIND","NE",536000,606020,0,0,1142020,0
"6189",11,"HIGH WIND","NH",0,595000,2,2,595000,4
"6190",11,"HIGH WIND","NJ",0,3365000,1,8,3365000,9
"6191",11,"HIGH WIND","NM",0,250,0,0,250,0
"6192",11,"HIGH WIND","NV",0,1158100,1,7,1158100,8
"6193",11,"HIGH WIND","NY",0,7807960,9,16,7807960,25
"6194",11,"HIGH WIND","OH",35000,5298000,0,2,5333000,2
"6195",11,"HIGH WIND","OK",0,440000,0,0,440000,0
"6196",11,"HIGH WIND","OR",0,1480500,0,0,1480500,0
"6197",11,"HIGH WIND","PA",0,6116000,6,13,6116000,19
"6198",11,"HIGH WIND","RI",0,454000,0,0,454000,0
"6199",11,"HIGH WIND","SC",0,250000,0,4,250000,4
"6200",11,"HIGH WIND","SD",0,348260,0,0,348260,0
"6201",11,"HIGH WIND","TN",0,358000,0,0,358000,0
"6202",11,"HIGH WIND","TX",0,312500,0,0,312500,0
"6203",11,"HIGH WIND","UT",50000,217050,0,0,267050,0
"6204",11,"HIGH WIND","VA",0,2068900,0,2,2068900,2
"6205",11,"HIGH WIND","VT",0,866500,0,0,866500,0
"6206",11,"HIGH WIND","WA",0,24473000,3,4,24473000,7
"6207",11,"HIGH WIND","WI",1580000,13313500,6,18,14893500,24
"6208",11,"HIGH WIND","WV",0,63600,0,1,63600,1
"6209",11,"HIGH WIND","WY",0,552000,1,2,552000,3
"6210",11,"HURRICANE/TYPHOON","FL",0,50000,0,0,50000,0
"6211",11,"HURRICANE/TYPHOON","GU",6e+05,16200000,0,0,16800000,0
"6212",11,"HURRICANE/TYPHOON","NC",0,5e+05,0,0,5e+05,0
"6213",11,"HURRICANE/TYPHOON","PR",1.4e+07,9.1e+07,0,0,1.05e+08,0
"6214",11,"HURRICANE/TYPHOON","VI",0,2.6e+07,0,0,2.6e+07,0
"6215",11,"ICE STORM","AK",0,184000,0,31,184000,31
"6216",11,"ICE STORM","AR",0,1800000,0,0,1800000,0
"6217",11,"ICE STORM","AZ",0,10000,0,0,10000,0
"6218",11,"ICE STORM","CT",0,2500000,0,0,2500000,0
"6219",11,"ICE STORM","IA",0,185000,0,0,185000,0
"6220",11,"ICE STORM","KS",0,78000,0,0,78000,0
"6221",11,"ICE STORM","MA",0,1350000,0,0,1350000,0
"6222",11,"ICE STORM","MN",0,1.3e+07,0,0,1.3e+07,0
"6223",11,"ICE STORM","MO",0,4235000,0,0,4235000,0
"6224",11,"ICE STORM","MT",0,0,2,0,0,2
"6225",11,"ICE STORM","NE",0,14000,0,0,14000,0
"6226",11,"ICE STORM","NH",0,150000,0,0,150000,0
"6227",11,"ICE STORM","NY",0,295000,1,7,295000,8
"6228",11,"ICE STORM","OK",0,1e+06,0,0,1e+06,0
"6229",11,"ICE STORM","PA",0,81000,0,2,81000,2
"6230",11,"ICE STORM","SD",0,17354000,3,50,17354000,53
"6231",11,"ICE STORM","TX",0,50050000,1,3,50050000,4
"6232",11,"ICE STORM","WA",5700000,6350000,2,50,12050000,52
"6233",11,"ICE STORM","WI",0,150000,0,0,150000,0
"6234",11,"ICE STORM","WV",0,2000,0,0,2000,0
"6235",11,"LAKE-EFFECT SNOW","MI",0,20000,0,0,20000,0
"6236",11,"LAKE-EFFECT SNOW","NY",0,163000,0,0,163000,0
"6237",11,"LAKE-EFFECT SNOW","OH",0,475000,0,0,475000,0
"6238",11,"LAKE-EFFECT SNOW","PA",0,640000,0,0,640000,0
"6239",11,"LIGHTNING","AL",0,201000,0,1,201000,1
"6240",11,"LIGHTNING","AR",0,885000,0,1,885000,1
"6241",11,"LIGHTNING","AZ",0,0,0,1,0,1
"6242",11,"LIGHTNING","CA",0,5017000,0,1,5017000,1
"6243",11,"LIGHTNING","CT",0,20000,0,1,20000,1
"6244",11,"LIGHTNING","FL",0,76000,0,3,76000,3
"6245",11,"LIGHTNING","GA",0,678750,0,0,678750,0
"6246",11,"LIGHTNING","GU",0,20000,0,0,20000,0
"6247",11,"LIGHTNING","HI",0,0,0,3,0,3
"6248",11,"LIGHTNING","IA",0,125000,0,0,125000,0
"6249",11,"LIGHTNING","ID",0,55000,0,0,55000,0
"6250",11,"LIGHTNING","IL",0,30000,0,0,30000,0
"6251",11,"LIGHTNING","IN",0,303000,0,0,303000,0
"6252",11,"LIGHTNING","KS",0,0,1,1,0,2
"6253",11,"LIGHTNING","KY",0,80000,0,0,80000,0
"6254",11,"LIGHTNING","LA",0,165000,0,1,165000,1
"6255",11,"LIGHTNING","MA",0,15000,0,0,15000,0
"6256",11,"LIGHTNING","MD",0,5e+05,0,0,5e+05,0
"6257",11,"LIGHTNING","MI",0,325000,0,2,325000,2
"6258",11,"LIGHTNING","MN",0,75000,0,0,75000,0
"6259",11,"LIGHTNING","MO",0,10000,0,0,10000,0
"6260",11,"LIGHTNING","MS",0,66000,0,5,66000,5
"6261",11,"LIGHTNING","NC",0,10000,0,0,10000,0
"6262",11,"LIGHTNING","NY",0,165000,0,0,165000,0
"6263",11,"LIGHTNING","OK",0,714300,0,4,714300,4
"6264",11,"LIGHTNING","PR",0,5000,0,0,5000,0
"6265",11,"LIGHTNING","RI",0,2000,0,0,2000,0
"6266",11,"LIGHTNING","SC",0,65000,0,0,65000,0
"6267",11,"LIGHTNING","TN",0,34900,0,2,34900,2
"6268",11,"LIGHTNING","TX",0,1219200,0,2,1219200,2
"6269",11,"LIGHTNING","VA",0,620000,0,0,620000,0
"6270",11,"LIGHTNING","VI",0,500,0,0,500,0
"6271",11,"LIGHTNING","VT",0,248000,0,0,248000,0
"6272",11,"LIGHTNING","WA",0,28000,0,1,28000,1
"6273",11,"LIGHTNING","WI",0,1170800,0,0,1170800,0
"6274",11,"MARINE STRONG WIND","GM",0,26500,0,0,26500,0
"6275",11,"MARINE STRONG WIND","LM",0,200,0,0,200,0
"6276",11,"MARINE THUNDERSTORM WIND","GM",0,0,1,0,0,1
"6277",11,"OTHER EVENT NON IDENTIFIED","CA",0,0,0,1,0,1
"6278",11,"OTHER EVENT NON IDENTIFIED","WI",0,40000,0,0,40000,0
"6279",11,"RIP CURRENT","CA",0,0,4,2,0,6
"6280",11,"RIP CURRENT","FL",0,0,13,12,0,25
"6281",11,"RIP CURRENT","GU",0,0,3,1,0,4
"6282",11,"SEICHE","NY",0,25000,0,0,25000,0
"6283",11,"STORM SURGE/TIDE","AK",0,612000,0,0,612000,0
"6284",11,"STORM SURGE/TIDE","FL",0,4005000,0,5,4005000,5
"6285",11,"STORM SURGE/TIDE","MA",0,75000,0,0,75000,0
"6286",11,"STORM SURGE/TIDE","WA",0,5000,0,0,5000,0
"6287",11,"STRONG WIND","AK",0,1200,0,0,1200,0
"6288",11,"STRONG WIND","AL",0,14000,0,0,14000,0
"6289",11,"STRONG WIND","AR",0,12000,0,0,12000,0
"6290",11,"STRONG WIND","AZ",0,25000,0,0,25000,0
"6291",11,"STRONG WIND","CA",0,2149200,1,3,2149200,4
"6292",11,"STRONG WIND","CO",0,21000,0,0,21000,0
"6293",11,"STRONG WIND","CT",0,2000,0,1,2000,1
"6294",11,"STRONG WIND","DC",0,5000,0,3,5000,3
"6295",11,"STRONG WIND","DE",0,33750,0,0,33750,0
"6296",11,"STRONG WIND","FL",0,15000,1,0,15000,1
"6297",11,"STRONG WIND","GA",0,79500,0,0,79500,0
"6298",11,"STRONG WIND","HI",0,0,1,1,0,2
"6299",11,"STRONG WIND","ID",3000,0,0,0,3000,0
"6300",11,"STRONG WIND","IL",0,68000,0,4,68000,4
"6301",11,"STRONG WIND","IN",0,6000,0,0,6000,0
"6302",11,"STRONG WIND","KS",0,7000,0,0,7000,0
"6303",11,"STRONG WIND","KY",6000,43000,0,0,49000,0
"6304",11,"STRONG WIND","MA",0,185440,1,0,185440,1
"6305",11,"STRONG WIND","MD",0,1828000,1,1,1828000,2
"6306",11,"STRONG WIND","ME",0,51000,0,0,51000,0
"6307",11,"STRONG WIND","MI",0,7204000,0,0,7204000,0
"6308",11,"STRONG WIND","MN",0,3500,0,0,3500,0
"6309",11,"STRONG WIND","MO",0,1000,0,0,1000,0
"6310",11,"STRONG WIND","MS",0,47000,0,0,47000,0
"6311",11,"STRONG WIND","MT",24000,0,0,0,24000,0
"6312",11,"STRONG WIND","NC",8000,35500,1,0,43500,1
"6313",11,"STRONG WIND","NH",0,69000,0,0,69000,0
"6314",11,"STRONG WIND","NJ",0,263000,2,1,263000,3
"6315",11,"STRONG WIND","NM",0,30000,0,0,30000,0
"6316",11,"STRONG WIND","NV",0,26300,0,0,26300,0
"6317",11,"STRONG WIND","NY",0,150250,0,3,150250,3
"6318",11,"STRONG WIND","OH",0,170000,0,0,170000,0
"6319",11,"STRONG WIND","OK",0,22750,0,0,22750,0
"6320",11,"STRONG WIND","OR",0,46500,0,0,46500,0
"6321",11,"STRONG WIND","PA",0,358650,1,3,358650,4
"6322",11,"STRONG WIND","RI",0,7000,0,0,7000,0
"6323",11,"STRONG WIND","SC",0,27000,2,0,27000,2
"6324",11,"STRONG WIND","TN",0,10000,0,0,10000,0
"6325",11,"STRONG WIND","TX",0,160500,0,1,160500,1
"6326",11,"STRONG WIND","UT",0,5000,0,0,5000,0
"6327",11,"STRONG WIND","VA",0,1200600,0,2,1200600,2
"6328",11,"STRONG WIND","VT",0,42000,0,0,42000,0
"6329",11,"STRONG WIND","WA",0,1464000,1,0,1464000,1
"6330",11,"STRONG WIND","WI",0,61000,2,0,61000,2
"6331",11,"STRONG WIND","WV",0,130000,0,0,130000,0
"6332",11,"THUNDERSTORM WIND","AL",7000,2815000,1,7,2822000,8
"6333",11,"THUNDERSTORM WIND","AR",0,5739450,0,29,5739450,29
"6334",11,"THUNDERSTORM WIND","AZ",0,1500,0,0,1500,0
"6335",11,"THUNDERSTORM WIND","CA",0,112500,0,0,112500,0
"6336",11,"THUNDERSTORM WIND","CT",0,55000,0,0,55000,0
"6337",11,"THUNDERSTORM WIND","DC",0,14000,0,0,14000,0
"6338",11,"THUNDERSTORM WIND","DE",0,1000500,0,1,1000500,1
"6339",11,"THUNDERSTORM WIND","FL",0,1216750,1,10,1216750,11
"6340",11,"THUNDERSTORM WIND","GA",62000,5875820,1,11,5937820,12
"6341",11,"THUNDERSTORM WIND","HI",0,15000,0,0,15000,0
"6342",11,"THUNDERSTORM WIND","IA",0,154000,0,2,154000,2
"6343",11,"THUNDERSTORM WIND","ID",18000,136500,0,0,154500,0
"6344",11,"THUNDERSTORM WIND","IL",0,1567000,2,44,1567000,46
"6345",11,"THUNDERSTORM WIND","IN",0,2891500,0,2,2891500,2
"6346",11,"THUNDERSTORM WIND","KS",0,137000,0,3,137000,3
"6347",11,"THUNDERSTORM WIND","KY",5e+05,5294500,0,33,5794500,33
"6348",11,"THUNDERSTORM WIND","LA",30000,4688900,0,17,4718900,17
"6349",11,"THUNDERSTORM WIND","MA",0,8000,0,0,8000,0
"6350",11,"THUNDERSTORM WIND","MD",50000,3648750,0,5,3698750,5
"6351",11,"THUNDERSTORM WIND","MI",0,471000,0,1,471000,1
"6352",11,"THUNDERSTORM WIND","MO",0,897735,0,4,897735,4
"6353",11,"THUNDERSTORM WIND","MS",190000,8741650,0,27,8931650,27
"6354",11,"THUNDERSTORM WIND","NC",26000,1819000,0,6,1845000,6
"6355",11,"THUNDERSTORM WIND","NJ",0,140000,4,12,140000,16
"6356",11,"THUNDERSTORM WIND","NY",0,1194000,0,31,1194000,31
"6357",11,"THUNDERSTORM WIND","OH",20000,9629000,0,1,9649000,1
"6358",11,"THUNDERSTORM WIND","OK",0,1028160,1,6,1028160,7
"6359",11,"THUNDERSTORM WIND","PA",0,1649000,3,16,1649000,19
"6360",11,"THUNDERSTORM WIND","SC",0,734500,0,3,734500,3
"6361",11,"THUNDERSTORM WIND","TN",652000,6863100,2,7,7515100,9
"6362",11,"THUNDERSTORM WIND","TX",8000,33171800,5,71,33179800,76
"6363",11,"THUNDERSTORM WIND","UT",0,20000,0,0,20000,0
"6364",11,"THUNDERSTORM WIND","VA",105000,1909800,1,11,2014800,12
"6365",11,"THUNDERSTORM WIND","VT",0,50000,0,1,50000,1
"6366",11,"THUNDERSTORM WIND","WA",0,1e+05,0,0,1e+05,0
"6367",11,"THUNDERSTORM WIND","WV",0,622500,0,0,622500,0
"6368",11,"TORNADO","AL",33500,604829750,48,1057,604863250,1105
"6369",11,"TORNADO","AR",0,276908500,18,245,276908500,263
"6370",11,"TORNADO","AZ",0,285000,0,0,285000,0
"6371",11,"TORNADO","CA",0,5709750,0,12,5709750,12
"6372",11,"TORNADO","DE",0,250000,0,1,250000,1
"6373",11,"TORNADO","FL",2000,109281590,4,176,109283590,180
"6374",11,"TORNADO","GA",120000,127728250,8,317,127848250,325
"6375",11,"TORNADO","HI",0,250,0,0,250,0
"6376",11,"TORNADO","IA",0,23812500,1,17,23812500,18
"6377",11,"TORNADO","IL",0,124902750,2,139,124902750,141
"6378",11,"TORNADO","IN",0,124767500,24,331,124767500,355
"6379",11,"TORNADO","KS",0,6401750,0,30,6401750,30
"6380",11,"TORNADO","KY",80000,61538000,4,122,61618000,126
"6381",11,"TORNADO","LA",0,135089750,14,311,135089750,325
"6382",11,"TORNADO","MA",0,2530500,0,0,2530500,0
"6383",11,"TORNADO","MD",10000,20188000,0,4,20198000,4
"6384",11,"TORNADO","ME",0,301250,0,0,301250,0
"6385",11,"TORNADO","MI",0,650000,1,12,650000,13
"6386",11,"TORNADO","MO",750000,203975000,10,178,204725000,188
"6387",11,"TORNADO","MS",560000,330152280,31,686,330712280,717
"6388",11,"TORNADO","NC",402000,321342750,19,302,321744750,321
"6389",11,"TORNADO","ND",0,55000,0,2,55000,2
"6390",11,"TORNADO","NJ",0,3602500,0,1,3602500,1
"6391",11,"TORNADO","NY",0,51464000,9,19,51464000,28
"6392",11,"TORNADO","OH",0,181056200,7,76,181056200,83
"6393",11,"TORNADO","OK",0,52579240,5,105,52579240,110
"6394",11,"TORNADO","OR",0,887500,0,0,887500,0
"6395",11,"TORNADO","PA",0,15272500,1,47,15272500,48
"6396",11,"TORNADO","SC",35000,19506750,4,55,19541750,59
"6397",11,"TORNADO","TN",10000,93434000,24,165,93444000,189
"6398",11,"TORNADO","TX",4040000,493613680,17,538,497653680,555
"6399",11,"TORNADO","UT",0,25000,0,0,25000,0
"6400",11,"TORNADO","VA",0,4852500,0,8,4852500,8
"6401",11,"TORNADO","WA",0,75000,0,0,75000,0
"6402",11,"TORNADO","WI",0,6279500,0,1,6279500,1
"6403",11,"TORNADO","WV",0,250000,0,3,250000,3
"6404",11,"TROPICAL DEPRESSION","AL",0,2000,0,0,2000,0
"6405",11,"TROPICAL STORM","FL",20500000,30720000,10,108,51220000,118
"6406",11,"TROPICAL STORM","MS",0,1000,0,0,1000,0
"6407",11,"TSUNAMI","CA",0,9203000,0,0,9203000,0
"6408",11,"WATERSPOUT","FL",0,1005000,0,0,1005000,0
"6409",11,"WATERSPOUT","LA",0,1000,0,0,1000,0
"6410",11,"WILDFIRE","CA",0,1089632000,5,197,1089632000,202
"6411",11,"WILDFIRE","GA",0,143500,0,0,143500,0
"6412",11,"WILDFIRE","HI",15000,0,0,0,15000,0
"6413",11,"WILDFIRE","IL",0,75000,0,0,75000,0
"6414",11,"WILDFIRE","KS",0,1e+05,0,1,1e+05,1
"6415",11,"WILDFIRE","KY",0,15000,0,0,15000,0
"6416",11,"WILDFIRE","MO",0,28000,0,0,28000,0
"6417",11,"WILDFIRE","NJ",0,0,0,1,0,1
"6418",11,"WILDFIRE","NM",0,5e+05,0,0,5e+05,0
"6419",11,"WILDFIRE","OK",0,3850000,2,15,3850000,17
"6420",11,"WILDFIRE","OR",500,15000,0,0,15500,0
"6421",11,"WILDFIRE","TN",0,1e+05,0,0,1e+05,0
"6422",11,"WILDFIRE","TX",0,1064000,0,0,1064000,0
"6423",11,"WILDFIRE","VA",95000,0,0,0,95000,0
"6424",11,"WILDFIRE","WV",0,13000,1,0,13000,1
"6425",11,"WINTER STORM","AZ",0,0,1,5,0,6
"6426",11,"WINTER STORM","CO",0,300500,1,0,300500,1
"6427",11,"WINTER STORM","CT",0,115000,0,0,115000,0
"6428",11,"WINTER STORM","IA",0,208500,1,11,208500,12
"6429",11,"WINTER STORM","IL",0,0,0,5,0,5
"6430",11,"WINTER STORM","KS",0,82000,1,5,82000,6
"6431",11,"WINTER STORM","MA",0,35000,0,0,35000,0
"6432",11,"WINTER STORM","MI",0,2092000,0,0,2092000,0
"6433",11,"WINTER STORM","MN",0,4490000,0,0,4490000,0
"6434",11,"WINTER STORM","MO",0,3e+05,0,0,3e+05,0
"6435",11,"WINTER STORM","MT",0,3825000,2,1,3825000,3
"6436",11,"WINTER STORM","ND",0,3092000,0,7,3092000,7
"6437",11,"WINTER STORM","NE",0,3053000,0,0,3053000,0
"6438",11,"WINTER STORM","NY",0,504000,0,0,504000,0
"6439",11,"WINTER STORM","OH",0,275000,0,0,275000,0
"6440",11,"WINTER STORM","OR",0,15000,1,3,15000,4
"6441",11,"WINTER STORM","PA",0,3e+05,0,0,3e+05,0
"6442",11,"WINTER STORM","SD",0,1e+05,0,1,1e+05,1
"6443",11,"WINTER STORM","TX",5e+05,20000,0,0,520000,0
"6444",11,"WINTER STORM","UT",50000,2500000,3,24,2550000,27
"6445",11,"WINTER STORM","VT",0,891000,0,4,891000,4
"6446",11,"WINTER STORM","WI",0,1e+05,0,0,1e+05,0
"6447",11,"WINTER WEATHER","AZ",0,130000,0,2,130000,2
"6448",11,"WINTER WEATHER","CO",0,1000,0,0,1000,0
"6449",11,"WINTER WEATHER","IA",0,5000,0,0,5000,0
"6450",11,"WINTER WEATHER","MD",0,4000,0,0,4000,0
"6451",11,"WINTER WEATHER","MI",0,45500,0,0,45500,0
"6452",11,"WINTER WEATHER","MN",0,5000,0,0,5000,0
"6453",11,"WINTER WEATHER","NE",0,120000,0,0,120000,0
"6454",11,"WINTER WEATHER","NY",0,65000,0,6,65000,6
"6455",11,"WINTER WEATHER","OK",0,5000,0,0,5000,0
"6456",11,"WINTER WEATHER","PA",0,5000,0,0,5000,0
"6457",11,"WINTER WEATHER","TX",0,486000,0,0,486000,0
"6458",11,"WINTER WEATHER","VT",0,179000,0,0,179000,0
"6459",11,"WINTER WEATHER","WA",0,250000,0,0,250000,0
"6460",12,"ASTRONOMICAL LOW TIDE","CA",0,120000,0,0,120000,0
"6461",12,"AVALANCHE","AK",0,13000,5,1,13000,6
"6462",12,"AVALANCHE","CA",0,0,1,3,0,4
"6463",12,"AVALANCHE","CO",0,0,6,5,0,11
"6464",12,"AVALANCHE","ID",0,0,1,0,0,1
"6465",12,"AVALANCHE","MT",0,0,1,2,0,3
"6466",12,"AVALANCHE","NV",0,0,1,1,0,2
"6467",12,"AVALANCHE","UT",0,0,15,6,0,21
"6468",12,"AVALANCHE","WA",0,0,13,15,0,28
"6469",12,"AVALANCHE","WY",0,15000,6,9,15000,15
"6470",12,"BLIZZARD","AK",0,0,2,1,0,3
"6471",12,"BLIZZARD","CA",0,50000,0,0,50000,0
"6472",12,"BLIZZARD","CO",0,10000,0,0,10000,0
"6473",12,"BLIZZARD","IA",0,3615000,0,1,3615000,1
"6474",12,"BLIZZARD","ID",0,0,3,0,0,3
"6475",12,"BLIZZARD","MA",0,1e+05,0,0,1e+05,0
"6476",12,"BLIZZARD","MN",0,5000,1,5,5000,6
"6477",12,"BLIZZARD","MT",0,2e+05,1,2,2e+05,3
"6478",12,"BLIZZARD","ND",0,0,1,1,0,2
"6479",12,"BLIZZARD","NE",0,3000,0,1,3000,1
"6480",12,"BLIZZARD","OH",0,8e+05,1,0,8e+05,1
"6481",12,"BLIZZARD","OK",0,6100000,0,0,6100000,0
"6482",12,"BLIZZARD","OR",0,1e+05,0,0,1e+05,0
"6483",12,"BLIZZARD","SD",0,160000,1,1,160000,2
"6484",12,"BLIZZARD","TX",0,5e+05,0,0,5e+05,0
"6485",12,"BLIZZARD","WA",0,16000,0,0,16000,0
"6486",12,"BLIZZARD","WY",0,10000,1,0,10000,1
"6487",12,"COASTAL FLOOD","CA",0,450000,0,1,450000,1
"6488",12,"COASTAL FLOOD","CT",0,0,1,0,0,1
"6489",12,"COASTAL FLOOD","IN",0,5000,0,0,5000,0
"6490",12,"COASTAL FLOOD","MA",0,2480000,0,0,2480000,0
"6491",12,"COASTAL FLOOD","MD",0,5000,0,0,5000,0
"6492",12,"COASTAL FLOOD","ME",0,5000,0,0,5000,0
"6493",12,"COASTAL FLOOD","NC",0,10000,0,0,10000,0
"6494",12,"COASTAL FLOOD","NH",0,1000,0,0,1000,0
"6495",12,"COASTAL FLOOD","NY",0,7e+06,1,1,7e+06,2
"6496",12,"COASTAL FLOOD","OR",0,18300000,0,0,18300000,0
"6497",12,"COASTAL FLOOD","PR",0,15000,0,0,15000,0
"6498",12,"COASTAL FLOOD","SC",0,10000,0,0,10000,0
"6499",12,"COASTAL FLOOD","VA",0,80000,0,0,80000,0
"6500",12,"COASTAL FLOOD","WA",0,5100000,0,0,5100000,0
"6501",12,"COLD/WIND CHILL","AL",0,0,4,0,0,4
"6502",12,"COLD/WIND CHILL","AR",0,0,2,0,0,2
"6503",12,"COLD/WIND CHILL","CA",603400000,60075000,1,16,663475000,17
"6504",12,"COLD/WIND CHILL","CO",0,0,4,15,0,19
"6505",12,"COLD/WIND CHILL","DC",0,0,1,0,0,1
"6506",12,"COLD/WIND CHILL","FL",2e+06,0,1,0,2e+06,1
"6507",12,"COLD/WIND CHILL","IA",0,0,1,0,0,1
"6508",12,"COLD/WIND CHILL","IL",0,0,28,0,0,28
"6509",12,"COLD/WIND CHILL","IN",0,0,1,0,0,1
"6510",12,"COLD/WIND CHILL","MI",0,975000,6,0,975000,6
"6511",12,"COLD/WIND CHILL","MO",105000,125000,2,0,230000,2
"6512",12,"COLD/WIND CHILL","MS",0,0,1,0,0,1
"6513",12,"COLD/WIND CHILL","NC",0,0,1,0,0,1
"6514",12,"COLD/WIND CHILL","ND",0,0,2,0,0,2
"6515",12,"COLD/WIND CHILL","NM",0,0,3,0,0,3
"6516",12,"COLD/WIND CHILL","NV",0,0,1,0,0,1
"6517",12,"COLD/WIND CHILL","OH",0,712000,5,1,712000,6
"6518",12,"COLD/WIND CHILL","PA",0,110000,3,0,110000,3
"6519",12,"COLD/WIND CHILL","SC",0,0,9,0,0,9
"6520",12,"COLD/WIND CHILL","SD",0,0,1,0,0,1
"6521",12,"COLD/WIND CHILL","TN",0,0,1,0,0,1
"6522",12,"COLD/WIND CHILL","TX",0,0,1,0,0,1
"6523",12,"COLD/WIND CHILL","UT",0,20000,0,0,20000,0
"6524",12,"COLD/WIND CHILL","VA",0,0,1,0,0,1
"6525",12,"COLD/WIND CHILL","WI",0,0,3,21,0,24
"6526",12,"DEBRIS FLOW","AR",0,50000,0,0,50000,0
"6527",12,"DEBRIS FLOW","CA",0,75914000,14,10,75914000,24
"6528",12,"DEBRIS FLOW","GU",0,2e+05,0,0,2e+05,0
"6529",12,"DEBRIS FLOW","NC",0,75000,0,0,75000,0
"6530",12,"DEBRIS FLOW","OR",0,1585000,0,0,1585000,0
"6531",12,"DEBRIS FLOW","PR",0,4845500,0,1,4845500,1
"6532",12,"DEBRIS FLOW","WA",0,2250000,1,0,2250000,1
"6533",12,"DENSE FOG","AL",0,70000,0,0,70000,0
"6534",12,"DENSE FOG","AZ",0,0,0,10,0,10
"6535",12,"DENSE FOG","CA",0,4220000,15,67,4220000,82
"6536",12,"DENSE FOG","CO",0,150000,0,5,150000,5
"6537",12,"DENSE FOG","FL",0,850000,1,30,850000,31
"6538",12,"DENSE FOG","ID",0,0,0,3,0,3
"6539",12,"DENSE FOG","KS",0,50000,2,21,50000,23
"6540",12,"DENSE FOG","LA",0,28000,0,6,28000,6
"6541",12,"DENSE FOG","MN",0,10000,0,0,10000,0
"6542",12,"DENSE FOG","NE",0,45000,0,1,45000,1
"6543",12,"DENSE FOG","NJ",0,0,0,17,0,17
"6544",12,"DENSE FOG","NY",0,0,0,1,0,1
"6545",12,"DENSE FOG","OR",0,20000,0,10,20000,10
"6546",12,"DENSE FOG","TX",0,140000,0,0,140000,0
"6547",12,"DENSE FOG","WA",0,0,1,1,0,2
"6548",12,"DROUGHT","KS",6e+07,0,0,0,6e+07,0
"6549",12,"DROUGHT","LA",250450000,0,0,0,250450000,0
"6550",12,"DROUGHT","NE",4.8e+08,0,0,0,4.8e+08,0
"6551",12,"DROUGHT","NM",1.2e+07,2e+06,0,0,1.4e+07,0
"6552",12,"DROUGHT","OK",1500000,1e+07,0,0,11500000,0
"6553",12,"DROUGHT","TX",1495318000,73025000,0,0,1568343000,0
"6554",12,"DROUGHT","VI",2e+05,0,0,0,2e+05,0
"6555",12,"DUST STORM","CA",0,25000,0,0,25000,0
"6556",12,"DUST STORM","TX",0,15000,0,0,15000,0
"6557",12,"EXTREME COLD/WIND CHILL","CO",0,1e+05,0,0,1e+05,0
"6558",12,"EXTREME COLD/WIND CHILL","IL",0,0,17,5,0,22
"6559",12,"EXTREME COLD/WIND CHILL","KY",0,25000,0,0,25000,0
"6560",12,"EXTREME COLD/WIND CHILL","MN",0,0,1,0,0,1
"6561",12,"EXTREME COLD/WIND CHILL","MS",0,0,1,0,0,1
"6562",12,"EXTREME COLD/WIND CHILL","MT",0,0,1,0,0,1
"6563",12,"EXTREME COLD/WIND CHILL","ND",0,0,1,0,0,1
"6564",12,"EXTREME COLD/WIND CHILL","OH",0,0,1,0,0,1
"6565",12,"EXTREME COLD/WIND CHILL","TN",0,0,1,0,0,1
"6566",12,"EXTREME COLD/WIND CHILL","TX",0,0,1,0,0,1
"6567",12,"FLASH FLOOD","AL",0,2539000,1,0,2539000,1
"6568",12,"FLASH FLOOD","AR",10000,21487250,0,0,21497250,0
"6569",12,"FLASH FLOOD","AS",250000,250000,0,0,5e+05,0
"6570",12,"FLASH FLOOD","AZ",0,75000,0,0,75000,0
"6571",12,"FLASH FLOOD","CA",610000,16332500,3,8,16942500,11
"6572",12,"FLASH FLOOD","CT",0,12000,0,0,12000,0
"6573",12,"FLASH FLOOD","FL",0,6441000,0,0,6441000,0
"6574",12,"FLASH FLOOD","GA",0,251000,0,0,251000,0
"6575",12,"FLASH FLOOD","HI",0,0,0,2,0,2
"6576",12,"FLASH FLOOD","IA",0,50000,0,0,50000,0
"6577",12,"FLASH FLOOD","ID",0,15000,0,0,15000,0
"6578",12,"FLASH FLOOD","IL",0,1115000,0,0,1115000,0
"6579",12,"FLASH FLOOD","KY",0,248000,0,0,248000,0
"6580",12,"FLASH FLOOD","LA",0,3568000,2,1,3568000,3
"6581",12,"FLASH FLOOD","MA",0,10000,0,0,10000,0
"6582",12,"FLASH FLOOD","MD",0,2118000,0,0,2118000,0
"6583",12,"FLASH FLOOD","MO",0,36000,0,0,36000,0
"6584",12,"FLASH FLOOD","MS",0,2263500,0,0,2263500,0
"6585",12,"FLASH FLOOD","NC",0,20000,0,0,20000,0
"6586",12,"FLASH FLOOD","NV",0,1332000,0,0,1332000,0
"6587",12,"FLASH FLOOD","NY",0,2410000,1,0,2410000,1
"6588",12,"FLASH FLOOD","OH",0,80000,0,0,80000,0
"6589",12,"FLASH FLOOD","OK",0,510000,0,0,510000,0
"6590",12,"FLASH FLOOD","PA",0,724000,0,0,724000,0
"6591",12,"FLASH FLOOD","PR",50000,1448000,0,0,1498000,0
"6592",12,"FLASH FLOOD","SC",8000,97000,0,0,105000,0
"6593",12,"FLASH FLOOD","TN",0,141000,0,0,141000,0
"6594",12,"FLASH FLOOD","TX",2e+05,3502000,12,2,3702000,14
"6595",12,"FLASH FLOOD","VA",0,462250,0,0,462250,0
"6596",12,"FLASH FLOOD","VT",0,25000,0,0,25000,0
"6597",12,"FLASH FLOOD","WA",0,750000,1,0,750000,1
"6598",12,"FLASH FLOOD","WV",0,377000,0,0,377000,0
"6599",12,"FLOOD","AK",8000,752000,0,0,760000,0
"6600",12,"FLOOD","AL",0,1792000,0,0,1792000,0
"6601",12,"FLOOD","AR",250000,26224500,0,5,26474500,5
"6602",12,"FLOOD","AZ",0,4200000,0,0,4200000,0
"6603",12,"FLOOD","CA",43500000,625395000,7,2,668895000,9
"6604",12,"FLOOD","CO",0,500,0,0,500,0
"6605",12,"FLOOD","CT",0,153000,0,0,153000,0
"6606",12,"FLOOD","DE",0,0,0,1,0,1
"6607",12,"FLOOD","FL",14500000,12785000,0,0,27285000,0
"6608",12,"FLOOD","GA",0,297000,0,0,297000,0
"6609",12,"FLOOD","GU",0,20000,0,0,20000,0
"6610",12,"FLOOD","IA",0,1e+05,0,0,1e+05,0
"6611",12,"FLOOD","ID",0,15000,0,0,15000,0
"6612",12,"FLOOD","IL",0,13000,0,1,13000,1
"6613",12,"FLOOD","IN",0,392000,2,0,392000,2
"6614",12,"FLOOD","KY",0,815000,1,6,815000,7
"6615",12,"FLOOD","LA",0,50000,0,0,50000,0
"6616",12,"FLOOD","MA",0,158000,0,0,158000,0
"6617",12,"FLOOD","MD",0,10000,0,0,10000,0
"6618",12,"FLOOD","ME",0,1920000,0,0,1920000,0
"6619",12,"FLOOD","MI",0,3600000,0,0,3600000,0
"6620",12,"FLOOD","MO",0,186000,1,0,186000,1
"6621",12,"FLOOD","MS",0,29500,0,0,29500,0
"6622",12,"FLOOD","NC",0,5000,0,0,5000,0
"6623",12,"FLOOD","NH",0,60000,0,0,60000,0
"6624",12,"FLOOD","NV",0,12602000,0,0,12602000,0
"6625",12,"FLOOD","NY",0,3245000,0,0,3245000,0
"6626",12,"FLOOD","OH",0,193000,0,0,193000,0
"6627",12,"FLOOD","OR",0,101374000,1,6,101374000,7
"6628",12,"FLOOD","PA",0,2430000,0,0,2430000,0
"6629",12,"FLOOD","PR",0,49000,0,0,49000,0
"6630",12,"FLOOD","RI",0,57000,0,0,57000,0
"6631",12,"FLOOD","SC",0,1000,0,0,1000,0
"6632",12,"FLOOD","TN",0,231000,1,0,231000,1
"6633",12,"FLOOD","UT",0,20502000,0,0,20502000,0
"6634",12,"FLOOD","VA",0,1550500,0,0,1550500,0
"6635",12,"FLOOD","VT",0,1475000,0,0,1475000,0
"6636",12,"FLOOD","WA",0,68412000,3,0,68412000,3
"6637",12,"FLOOD","WV",0,97000,1,0,97000,1
"6638",12,"FREEZING FOG","ID",0,0,1,0,0,1
"6639",12,"FREEZING FOG","VT",0,50000,0,0,50000,0
"6640",12,"FROST/FREEZE","CA",83430000,125000,0,0,83555000,0
"6641",12,"FROST/FREEZE","FL",38550000,0,0,0,38550000,0
"6642",12,"FROST/FREEZE","IA",0,5000,0,0,5000,0
"6643",12,"FROST/FREEZE","MT",0,50000,0,0,50000,0
"6644",12,"FROST/FREEZE","NC",0,20000,0,0,20000,0
"6645",12,"FROST/FREEZE","OH",0,25000,0,2,25000,2
"6646",12,"FUNNEL CLOUD","FL",0,15000,0,0,15000,0
"6647",12,"HAIL","AL",4000,102000,0,0,106000,0
"6648",12,"HAIL","AR",0,10020,0,0,10020,0
"6649",12,"HAIL","CA",0,1e+05,0,0,1e+05,0
"6650",12,"HAIL","FL",0,54000,0,0,54000,0
"6651",12,"HAIL","GA",0,2165000,0,0,2165000,0
"6652",12,"HAIL","IA",0,3000,0,0,3000,0
"6653",12,"HAIL","LA",0,1e+05,0,0,1e+05,0
"6654",12,"HAIL","MS",0,56920,0,0,56920,0
"6655",12,"HAIL","OK",0,120000,0,0,120000,0
"6656",12,"HAIL","SD",0,10000,0,0,10000,0
"6657",12,"HAIL","TN",0,1540,0,0,1540,0
"6658",12,"HAIL","TX",0,826000,0,10,826000,10
"6659",12,"HAIL","WA",0,50000,0,0,50000,0
"6660",12,"HEAVY RAIN","AK",0,500,0,0,500,0
"6661",12,"HEAVY RAIN","AL",0,0,0,1,0,1
"6662",12,"HEAVY RAIN","AR",0,25000,0,0,25000,0
"6663",12,"HEAVY RAIN","AZ",0,15000,0,0,15000,0
"6664",12,"HEAVY RAIN","CA",0,2676000,3,15,2676000,18
"6665",12,"HEAVY RAIN","FL",0,30000,0,0,30000,0
"6666",12,"HEAVY RAIN","GA",0,11000,0,0,11000,0
"6667",12,"HEAVY RAIN","ID",0,550000,0,0,550000,0
"6668",12,"HEAVY RAIN","MI",0,2e+05,0,0,2e+05,0
"6669",12,"HEAVY RAIN","NC",0,1850000,0,0,1850000,0
"6670",12,"HEAVY RAIN","NV",0,120000,0,0,120000,0
"6671",12,"HEAVY RAIN","NY",0,1101000,0,0,1101000,0
"6672",12,"HEAVY RAIN","PR",0,28030,3,1,28030,4
"6673",12,"HEAVY RAIN","SC",353000,4860000,0,0,5213000,0
"6674",12,"HEAVY RAIN","VT",0,397000,0,0,397000,0
"6675",12,"HEAVY RAIN","WA",0,102030000,0,0,102030000,0
"6676",12,"HEAVY SNOW","AK",0,358000,2,2,358000,4
"6677",12,"HEAVY SNOW","AZ",0,0,1,26,0,27
"6678",12,"HEAVY SNOW","CA",0,110000,3,2,110000,5
"6679",12,"HEAVY SNOW","CO",0,0,1,0,0,1
"6680",12,"HEAVY SNOW","CT",0,6037000,1,0,6037000,1
"6681",12,"HEAVY SNOW","IA",0,765600,0,0,765600,0
"6682",12,"HEAVY SNOW","ID",0,615000,1,0,615000,1
"6683",12,"HEAVY SNOW","IL",0,0,4,0,0,4
"6684",12,"HEAVY SNOW","IN",2e+05,3665000,1,3,3865000,4
"6685",12,"HEAVY SNOW","KS",0,160000,2,17,160000,19
"6686",12,"HEAVY SNOW","KY",0,691400,0,0,691400,0
"6687",12,"HEAVY SNOW","MA",0,14997000,0,0,14997000,0
"6688",12,"HEAVY SNOW","ME",0,2e+05,0,0,2e+05,0
"6689",12,"HEAVY SNOW","MI",0,2085000,0,1,2085000,1
"6690",12,"HEAVY SNOW","MO",0,450000,0,0,450000,0
"6691",12,"HEAVY SNOW","MS",0,150000,0,0,150000,0
"6692",12,"HEAVY SNOW","MT",0,1e+05,0,0,1e+05,0
"6693",12,"HEAVY SNOW","NC",0,5000,1,1,5000,2
"6694",12,"HEAVY SNOW","ND",0,50000,0,0,50000,0
"6695",12,"HEAVY SNOW","NH",0,1510000,1,0,1510000,1
"6696",12,"HEAVY SNOW","NJ",0,1e+05,0,0,1e+05,0
"6697",12,"HEAVY SNOW","NM",0,1e+05,2,5,1e+05,7
"6698",12,"HEAVY SNOW","NV",0,1015000,0,2,1015000,2
"6699",12,"HEAVY SNOW","NY",0,32995000,0,2,32995000,2
"6700",12,"HEAVY SNOW","OH",0,9845000,0,0,9845000,0
"6701",12,"HEAVY SNOW","OK",0,1e+05,1,0,1e+05,1
"6702",12,"HEAVY SNOW","OR",0,0,0,6,0,6
"6703",12,"HEAVY SNOW","PA",0,5817000,0,100,5817000,100
"6704",12,"HEAVY SNOW","RI",0,5000,0,0,5000,0
"6705",12,"HEAVY SNOW","SD",0,180000,0,14,180000,14
"6706",12,"HEAVY SNOW","TN",0,20500,0,0,20500,0
"6707",12,"HEAVY SNOW","TX",0,255000,2,1,255000,3
"6708",12,"HEAVY SNOW","UT",0,750250,2,50,750250,52
"6709",12,"HEAVY SNOW","VA",0,2570500,0,0,2570500,0
"6710",12,"HEAVY SNOW","VT",0,1205000,1,0,1205000,1
"6711",12,"HEAVY SNOW","WA",0,32960000,3,6,32960000,9
"6712",12,"HEAVY SNOW","WV",0,2785000,0,0,2785000,0
"6713",12,"HIGH SURF","AK",0,150,0,0,150,0
"6714",12,"HIGH SURF","AS",0,2e+05,0,0,2e+05,0
"6715",12,"HIGH SURF","CA",0,527500,13,7,527500,20
"6716",12,"HIGH SURF","HI",0,450000,4,6,450000,10
"6717",12,"HIGH SURF","OR",0,0,4,0,0,4
"6718",12,"HIGH SURF","PR",0,0,3,6,0,9
"6719",12,"HIGH SURF","VA",0,50000,3,20,50000,23
"6720",12,"HIGH SURF","VI",0,10000,0,0,10000,0
"6721",12,"HIGH WIND","AK",30000,2399170,0,0,2429170,0
"6722",12,"HIGH WIND","AL",0,51000,0,0,51000,0
"6723",12,"HIGH WIND","AR",0,5000,0,0,5000,0
"6724",12,"HIGH WIND","AS",70000,50000,0,0,120000,0
"6725",12,"HIGH WIND","AZ",0,1631000,0,0,1631000,0
"6726",12,"HIGH WIND","CA",27010000,50602000,11,45,77612000,56
"6727",12,"HIGH WIND","CO",0,1108000,0,12,1108000,12
"6728",12,"HIGH WIND","CT",0,5285000,1,0,5285000,1
"6729",12,"HIGH WIND","DC",0,50000,0,0,50000,0
"6730",12,"HIGH WIND","DE",0,53000,0,0,53000,0
"6731",12,"HIGH WIND","FL",0,595000,2,2,595000,4
"6732",12,"HIGH WIND","GA",0,1282000,1,2,1282000,3
"6733",12,"HIGH WIND","HI",0,5640000,0,6,5640000,6
"6734",12,"HIGH WIND","IA",0,1959000,0,0,1959000,0
"6735",12,"HIGH WIND","ID",0,2074500,0,3,2074500,3
"6736",12,"HIGH WIND","IL",5000,43000,0,0,48000,0
"6737",12,"HIGH WIND","IN",0,207000,0,0,207000,0
"6738",12,"HIGH WIND","KS",0,156300,0,2,156300,2
"6739",12,"HIGH WIND","KY",0,164000,1,2,164000,3
"6740",12,"HIGH WIND","LA",0,578000,2,0,578000,2
"6741",12,"HIGH WIND","MA",0,8205000,0,0,8205000,0
"6742",12,"HIGH WIND","MD",0,449000,0,0,449000,0
"6743",12,"HIGH WIND","ME",0,0,0,1,0,1
"6744",12,"HIGH WIND","MI",0,1360000,0,2,1360000,2
"6745",12,"HIGH WIND","MN",0,15000,0,0,15000,0
"6746",12,"HIGH WIND","MO",0,1000,0,0,1000,0
"6747",12,"HIGH WIND","MS",0,58500,0,0,58500,0
"6748",12,"HIGH WIND","MT",0,273000,1,1,273000,2
"6749",12,"HIGH WIND","NC",0,1152000,1,5,1152000,6
"6750",12,"HIGH WIND","ND",0,30000,0,1,30000,1
"6751",12,"HIGH WIND","NE",0,75000,0,0,75000,0
"6752",12,"HIGH WIND","NH",0,20000,0,0,20000,0
"6753",12,"HIGH WIND","NJ",0,1100000,1,15,1100000,16
"6754",12,"HIGH WIND","NM",0,7049000,0,2,7049000,2
"6755",12,"HIGH WIND","NV",50,6371000,0,7,6371050,7
"6756",12,"HIGH WIND","NY",0,108451600,2,7,108451600,9
"6757",12,"HIGH WIND","OH",0,9366000,1,3,9366000,4
"6758",12,"HIGH WIND","OK",0,56000,0,0,56000,0
"6759",12,"HIGH WIND","OR",0,94282515,6,1,94282515,7
"6760",12,"HIGH WIND","PA",0,4800400,2,5,4800400,7
"6761",12,"HIGH WIND","RI",0,5298000,0,3,5298000,3
"6762",12,"HIGH WIND","SC",0,1500,0,0,1500,0
"6763",12,"HIGH WIND","SD",0,183000,3,6,183000,9
"6764",12,"HIGH WIND","TN",0,687000,0,0,687000,0
"6765",12,"HIGH WIND","TX",0,3709000,2,4,3709000,6
"6766",12,"HIGH WIND","UT",0,161500,0,6,161500,6
"6767",12,"HIGH WIND","VA",0,1568600,0,0,1568600,0
"6768",12,"HIGH WIND","VT",0,1340000,0,0,1340000,0
"6769",12,"HIGH WIND","WA",0,73609000,7,20,73609000,27
"6770",12,"HIGH WIND","WI",0,65000,0,0,65000,0
"6771",12,"HIGH WIND","WV",0,586500,0,0,586500,0
"6772",12,"HIGH WIND","WY",0,176200,0,0,176200,0
"6773",12,"HURRICANE/TYPHOON","GU",450000,759950000,2,318,760400000,320
"6774",12,"ICE STORM","AL",0,14526000,1,0,14526000,1
"6775",12,"ICE STORM","AR",0,537336000,2,0,537336000,2
"6776",12,"ICE STORM","AZ",0,1e+05,0,0,1e+05,0
"6777",12,"ICE STORM","CA",0,1e+06,2,0,1e+06,2
"6778",12,"ICE STORM","CT",0,6000,0,0,6000,0
"6779",12,"ICE STORM","GA",0,4372500,0,0,4372500,0
"6780",12,"ICE STORM","IA",0,16733150,1,0,16733150,1
"6781",12,"ICE STORM","IL",0,306000,0,0,306000,0
"6782",12,"ICE STORM","KS",0,143312000,6,6,143312000,12
"6783",12,"ICE STORM","KY",0,1031000,0,0,1031000,0
"6784",12,"ICE STORM","LA",0,138100000,3,2,138100000,5
"6785",12,"ICE STORM","MA",0,4.4e+07,0,0,4.4e+07,0
"6786",12,"ICE STORM","MD",0,5105000,0,0,5105000,0
"6787",12,"ICE STORM","ME",0,4930000,0,0,4930000,0
"6788",12,"ICE STORM","MI",0,530000,0,0,530000,0
"6789",12,"ICE STORM","MO",3500,13165050,0,0,13168550,0
"6790",12,"ICE STORM","MS",0,17154000,0,0,17154000,0
"6791",12,"ICE STORM","MT",0,5e+05,0,0,5e+05,0
"6792",12,"ICE STORM","NC",0,200722000,1,0,200722000,1
"6793",12,"ICE STORM","NE",0,17898700,2,4,17898700,6
"6794",12,"ICE STORM","NH",0,36359000,0,0,36359000,0
"6795",12,"ICE STORM","NJ",0,1e+06,0,0,1e+06,0
"6796",12,"ICE STORM","NV",0,5000,1,0,5000,1
"6797",12,"ICE STORM","NY",0,72000,0,0,72000,0
"6798",12,"ICE STORM","OH",0,746000,0,0,746000,0
"6799",12,"ICE STORM","OK",0,385590000,0,0,385590000,0
"6800",12,"ICE STORM","OR",0,0,0,28,0,28
"6801",12,"ICE STORM","PA",0,13000,0,40,13000,40
"6802",12,"ICE STORM","SC",0,101597000,0,0,101597000,0
"6803",12,"ICE STORM","TN",0,66000,0,0,66000,0
"6804",12,"ICE STORM","TX",0,155838000,6,0,155838000,6
"6805",12,"ICE STORM","VA",0,20241000,0,0,20241000,0
"6806",12,"ICE STORM","WA",0,1050000,1,21,1050000,22
"6807",12,"ICE STORM","WI",0,3e+05,0,0,3e+05,0
"6808",12,"ICE STORM","WV",0,30000,0,0,30000,0
"6809",12,"ICE STORM","WY",0,42000,1,2,42000,3
"6810",12,"LAKE-EFFECT SNOW","NY",0,647000,0,0,647000,0
"6811",12,"LAKE-EFFECT SNOW","OH",0,3165000,0,0,3165000,0
"6812",12,"LAKE-EFFECT SNOW","PA",0,2260000,0,0,2260000,0
"6813",12,"LIGHTNING","AL",0,84000,1,0,84000,1
"6814",12,"LIGHTNING","AR",0,675000,0,1,675000,1
"6815",12,"LIGHTNING","AZ",0,0,1,3,0,4
"6816",12,"LIGHTNING","CA",0,2000,0,1,2000,1
"6817",12,"LIGHTNING","FL",0,35000,0,3,35000,3
"6818",12,"LIGHTNING","GA",0,316500,0,1,316500,1
"6819",12,"LIGHTNING","ID",0,5000,0,0,5000,0
"6820",12,"LIGHTNING","KS",0,150000,0,0,150000,0
"6821",12,"LIGHTNING","LA",0,5789000,1,2,5789000,3
"6822",12,"LIGHTNING","MA",0,1e+05,0,0,1e+05,0
"6823",12,"LIGHTNING","MI",0,1100000,0,0,1100000,0
"6824",12,"LIGHTNING","MO",0,510000,0,0,510000,0
"6825",12,"LIGHTNING","MS",0,95000,0,0,95000,0
"6826",12,"LIGHTNING","NC",0,1501000,0,0,1501000,0
"6827",12,"LIGHTNING","NH",0,10000,0,0,10000,0
"6828",12,"LIGHTNING","NJ",0,302000,0,0,302000,0
"6829",12,"LIGHTNING","NM",0,50000,0,0,50000,0
"6830",12,"LIGHTNING","NY",0,168000,0,0,168000,0
"6831",12,"LIGHTNING","OK",0,173000,0,1,173000,1
"6832",12,"LIGHTNING","OR",0,0,0,1,0,1
"6833",12,"LIGHTNING","PA",0,260000,0,0,260000,0
"6834",12,"LIGHTNING","TN",0,213000,0,0,213000,0
"6835",12,"LIGHTNING","TX",0,625000,0,2,625000,2
"6836",12,"LIGHTNING","VT",0,347000,0,0,347000,0
"6837",12,"LIGHTNING","WA",0,53500,0,0,53500,0
"6838",12,"MARINE HAIL","CA",0,50000,1,2,50000,3
"6839",12,"MARINE HIGH WIND","PK",0,21000,0,0,21000,0
"6840",12,"MARINE STRONG WIND","PZ",0,1000,0,0,1000,0
"6841",12,"OTHER EVENT NON IDENTIFIED","MN",0,50000,0,0,50000,0
"6842",12,"OTHER EVENT NON IDENTIFIED","NY",0,0,1,22,0,23
"6843",12,"RIP CURRENT","CA",0,1e+05,2,18,1e+05,20
"6844",12,"RIP CURRENT","FL",0,0,4,12,0,16
"6845",12,"RIP CURRENT","GU",0,0,1,1,0,2
"6846",12,"RIP CURRENT","PR",0,0,2,0,0,2
"6847",12,"SEICHE","NY",0,1e+05,0,0,1e+05,0
"6848",12,"STORM SURGE/TIDE","CA",0,2226000,0,0,2226000,0
"6849",12,"STORM SURGE/TIDE","GU",850000,1150000,0,0,2e+06,0
"6850",12,"STORM SURGE/TIDE","LA",0,2000,0,0,2000,0
"6851",12,"STORM SURGE/TIDE","MA",0,50000,0,0,50000,0
"6852",12,"STORM SURGE/TIDE","ME",0,1e+05,0,0,1e+05,0
"6853",12,"STORM SURGE/TIDE","WA",0,9e+05,0,1,9e+05,1
"6854",12,"STRONG WIND","AL",0,386000,0,0,386000,0
"6855",12,"STRONG WIND","AR",0,465000,0,0,465000,0
"6856",12,"STRONG WIND","AZ",0,113000,1,0,113000,1
"6857",12,"STRONG WIND","CA",0,1585700,0,1,1585700,1
"6858",12,"STRONG WIND","CT",0,53000,0,1,53000,1
"6859",12,"STRONG WIND","DE",0,153500,1,1,153500,2
"6860",12,"STRONG WIND","FL",0,30000,0,0,30000,0
"6861",12,"STRONG WIND","GA",0,119000,0,0,119000,0
"6862",12,"STRONG WIND","HI",0,0,1,2,0,3
"6863",12,"STRONG WIND","ID",0,10000,0,0,10000,0
"6864",12,"STRONG WIND","IL",0,84000,0,5,84000,5
"6865",12,"STRONG WIND","IN",0,19250,0,0,19250,0
"6866",12,"STRONG WIND","KS",0,3000,0,0,3000,0
"6867",12,"STRONG WIND","KY",0,235500,0,0,235500,0
"6868",12,"STRONG WIND","LA",0,12000,0,1,12000,1
"6869",12,"STRONG WIND","MA",0,159960,0,4,159960,4
"6870",12,"STRONG WIND","MD",0,107200,0,0,107200,0
"6871",12,"STRONG WIND","ME",0,29000,1,2,29000,3
"6872",12,"STRONG WIND","MI",0,15000,0,0,15000,0
"6873",12,"STRONG WIND","MN",0,800,0,0,800,0
"6874",12,"STRONG WIND","MO",0,8000,0,0,8000,0
"6875",12,"STRONG WIND","MS",0,139000,0,1,139000,1
"6876",12,"STRONG WIND","NC",0,60000,0,0,60000,0
"6877",12,"STRONG WIND","NE",0,5000,0,0,5000,0
"6878",12,"STRONG WIND","NH",0,17000,0,3,17000,3
"6879",12,"STRONG WIND","NJ",0,379250,2,2,379250,4
"6880",12,"STRONG WIND","NV",0,659600,0,3,659600,3
"6881",12,"STRONG WIND","NY",0,218000,1,2,218000,3
"6882",12,"STRONG WIND","OH",0,95000,0,0,95000,0
"6883",12,"STRONG WIND","OR",0,25000,1,0,25000,1
"6884",12,"STRONG WIND","PA",0,412500,1,0,412500,1
"6885",12,"STRONG WIND","PR",0,3500,0,2,3500,2
"6886",12,"STRONG WIND","RI",0,5000,0,0,5000,0
"6887",12,"STRONG WIND","SC",0,8500,0,0,8500,0
"6888",12,"STRONG WIND","TN",20000,199000,0,0,219000,0
"6889",12,"STRONG WIND","TX",0,87500,2,2,87500,4
"6890",12,"STRONG WIND","VA",0,72000,1,0,72000,1
"6891",12,"STRONG WIND","VI",0,500,0,0,500,0
"6892",12,"STRONG WIND","VT",0,162000,0,0,162000,0
"6893",12,"STRONG WIND","WA",0,662000,0,2,662000,2
"6894",12,"STRONG WIND","WI",0,244500,0,0,244500,0
"6895",12,"STRONG WIND","WV",0,24000,0,1,24000,1
"6896",12,"THUNDERSTORM WIND","AL",23000,1802500,1,12,1825500,13
"6897",12,"THUNDERSTORM WIND","AR",0,1601500,0,4,1601500,4
"6898",12,"THUNDERSTORM WIND","AZ",0,350000,0,0,350000,0
"6899",12,"THUNDERSTORM WIND","CA",0,5763000,0,2,5763000,2
"6900",12,"THUNDERSTORM WIND","CT",0,7500,0,0,7500,0
"6901",12,"THUNDERSTORM WIND","DE",0,1e+05,0,0,1e+05,0
"6902",12,"THUNDERSTORM WIND","FL",25000,1581050,1,7,1606050,8
"6903",12,"THUNDERSTORM WIND","GA",0,3627500,0,12,3627500,12
"6904",12,"THUNDERSTORM WIND","IA",0,110000,0,0,110000,0
"6905",12,"THUNDERSTORM WIND","IL",0,1206000,0,0,1206000,0
"6906",12,"THUNDERSTORM WIND","IN",0,867600,0,1,867600,1
"6907",12,"THUNDERSTORM WIND","KS",0,240500,0,0,240500,0
"6908",12,"THUNDERSTORM WIND","KY",0,115000,0,0,115000,0
"6909",12,"THUNDERSTORM WIND","LA",0,5150000,3,5,5150000,8
"6910",12,"THUNDERSTORM WIND","MA",0,113000,0,0,113000,0
"6911",12,"THUNDERSTORM WIND","MD",0,16000,0,0,16000,0
"6912",12,"THUNDERSTORM WIND","MI",0,1479000,0,2,1479000,2
"6913",12,"THUNDERSTORM WIND","MO",0,295500,0,1,295500,1
"6914",12,"THUNDERSTORM WIND","MS",0,3440750,0,20,3440750,20
"6915",12,"THUNDERSTORM WIND","NC",0,76700,0,0,76700,0
"6916",12,"THUNDERSTORM WIND","NH",0,125000,0,0,125000,0
"6917",12,"THUNDERSTORM WIND","NJ",0,2250,0,2,2250,2
"6918",12,"THUNDERSTORM WIND","NM",0,350000,0,0,350000,0
"6919",12,"THUNDERSTORM WIND","NY",0,182500,0,0,182500,0
"6920",12,"THUNDERSTORM WIND","OH",0,387000,0,0,387000,0
"6921",12,"THUNDERSTORM WIND","OK",0,745200,0,0,745200,0
"6922",12,"THUNDERSTORM WIND","PA",0,1649000,0,3,1649000,3
"6923",12,"THUNDERSTORM WIND","PR",0,5000,0,0,5000,0
"6924",12,"THUNDERSTORM WIND","SC",0,250500,0,5,250500,5
"6925",12,"THUNDERSTORM WIND","SD",0,5000,0,0,5000,0
"6926",12,"THUNDERSTORM WIND","TN",142000,503000,0,2,645000,2
"6927",12,"THUNDERSTORM WIND","TX",2000,5339000,0,37,5341000,37
"6928",12,"THUNDERSTORM WIND","UT",0,40000,0,0,40000,0
"6929",12,"THUNDERSTORM WIND","VA",5000,79600,0,2,84600,2
"6930",12,"THUNDERSTORM WIND","VT",0,50000,0,0,50000,0
"6931",12,"THUNDERSTORM WIND","WA",0,1e+05,1,0,1e+05,1
"6932",12,"TORNADO","AL",2000,57536500,17,378,57538500,395
"6933",12,"TORNADO","AR",0,181123160,18,287,181123160,305
"6934",12,"TORNADO","AZ",0,275000,0,0,275000,0
"6935",12,"TORNADO","CA",5500,5559500,0,9,5565000,9
"6936",12,"TORNADO","FL",5000,88607780,6,215,88612780,221
"6937",12,"TORNADO","GA",250000,28678620,5,167,28928620,172
"6938",12,"TORNADO","HI",0,250000,0,0,250000,0
"6939",12,"TORNADO","IA",0,75000,0,0,75000,0
"6940",12,"TORNADO","IL",0,58752530,19,328,58752530,347
"6941",12,"TORNADO","IN",0,995000,0,6,995000,6
"6942",12,"TORNADO","KS",0,500250,0,2,500250,2
"6943",12,"TORNADO","KY",0,102500,0,3,102500,3
"6944",12,"TORNADO","LA",50000,331578670,14,466,331628670,480
"6945",12,"TORNADO","MA",0,250,0,0,250,0
"6946",12,"TORNADO","MD",0,10000,0,0,10000,0
"6947",12,"TORNADO","MO",0,174986060,18,222,174986060,240
"6948",12,"TORNADO","MS",5e+05,67416750,44,426,67916750,470
"6949",12,"TORNADO","NC",0,312750,0,1,312750,1
"6950",12,"TORNADO","NE",0,275000,0,0,275000,0
"6951",12,"TORNADO","NM",0,250000,0,0,250000,0
"6952",12,"TORNADO","OH",0,1025000,0,4,1025000,4
"6953",12,"TORNADO","OK",0,31856250,0,63,31856250,63
"6954",12,"TORNADO","OR",0,3760530,0,3,3760530,3
"6955",12,"TORNADO","PA",0,3115000,1,5,3115000,6
"6956",12,"TORNADO","SC",0,21134030,3,46,21134030,49
"6957",12,"TORNADO","TN",0,32225000,1,44,32225000,45
"6958",12,"TORNADO","TX",0,160741560,8,244,160741560,252
"6959",12,"TORNADO","UT",0,7500,0,0,7500,0
"6960",12,"TORNADO","VA",0,275000,0,7,275000,7
"6961",12,"TORNADO","WA",0,3e+05,0,1,3e+05,1
"6962",12,"TORNADO","WI",0,2780000,0,0,2780000,0
"6963",12,"TORNADO","WV",0,50000,0,1,50000,1
"6964",12,"TROPICAL STORM","GU",5000,1005000,0,0,1010000,0
"6965",12,"WATERSPOUT","FL",0,500,0,0,500,0
"6966",12,"WILDFIRE","CA",3000,12025000,0,7,12028000,7
"6967",12,"WILDFIRE","CO",0,130000,0,0,130000,0
"6968",12,"WILDFIRE","FL",0,0,1,0,0,1
"6969",12,"WILDFIRE","GA",0,600,0,0,600,0
"6970",12,"WILDFIRE","KY",0,10000,0,0,10000,0
"6971",12,"WILDFIRE","NM",5000,15000,0,0,20000,0
"6972",12,"WILDFIRE","OK",0,2025000,1,2,2025000,3
"6973",12,"WILDFIRE","TX",0,17042000,3,26,17042000,29
"6974",12,"WINTER STORM","AK",0,30000,0,0,30000,0
"6975",12,"WINTER STORM","AL",320000,270000,0,0,590000,0
"6976",12,"WINTER STORM","AR",0,5808000,0,2,5808000,2
"6977",12,"WINTER STORM","AZ",0,0,1,5,0,6
"6978",12,"WINTER STORM","CA",0,1185000,2,2,1185000,4
"6979",12,"WINTER STORM","CT",0,95000,0,0,95000,0
"6980",12,"WINTER STORM","FL",0,175000,0,1,175000,1
"6981",12,"WINTER STORM","IA",0,1594000,0,4,1594000,4
"6982",12,"WINTER STORM","ID",0,330000,0,6,330000,6
"6983",12,"WINTER STORM","IL",0,100001,4,2,100001,6
"6984",12,"WINTER STORM","IN",0,260000,0,0,260000,0
"6985",12,"WINTER STORM","KS",0,39600000,3,3,39600000,6
"6986",12,"WINTER STORM","KY",0,1718200,0,0,1718200,0
"6987",12,"WINTER STORM","MA",0,433000,0,0,433000,0
"6988",12,"WINTER STORM","MD",0,2000,2,0,2000,2
"6989",12,"WINTER STORM","MI",0,3e+05,0,0,3e+05,0
"6990",12,"WINTER STORM","MN",0,18337000,1,0,18337000,1
"6991",12,"WINTER STORM","MO",0,2000,2,0,2000,2
"6992",12,"WINTER STORM","MS",0,18000,0,0,18000,0
"6993",12,"WINTER STORM","MT",0,0,1,0,0,1
"6994",12,"WINTER STORM","NC",0,45000,0,0,45000,0
"6995",12,"WINTER STORM","NE",0,19124000,0,1,19124000,1
"6996",12,"WINTER STORM","NH",0,124000,0,0,124000,0
"6997",12,"WINTER STORM","NM",4e+06,2500000,0,0,6500000,0
"6998",12,"WINTER STORM","NV",0,210000,1,10,210000,11
"6999",12,"WINTER STORM","NY",0,1417000,0,5,1417000,5
"7000",12,"WINTER STORM","OH",0,100961000,0,0,100961000,0
"7001",12,"WINTER STORM","OK",0,8880000,0,1,8880000,1
"7002",12,"WINTER STORM","OR",0,470000,1,6,470000,7
"7003",12,"WINTER STORM","PA",0,3555000,0,1,3555000,1
"7004",12,"WINTER STORM","RI",0,125000,0,2,125000,2
"7005",12,"WINTER STORM","SD",0,270000,0,0,270000,0
"7006",12,"WINTER STORM","TN",0,1816000,0,17,1816000,17
"7007",12,"WINTER STORM","TX",0,2200000,0,0,2200000,0
"7008",12,"WINTER STORM","UT",10000,3370000,4,63,3380000,67
"7009",12,"WINTER STORM","VA",0,84000,0,11,84000,11
"7010",12,"WINTER STORM","VT",0,2965000,1,0,2965000,1
"7011",12,"WINTER STORM","WA",0,1977000,0,0,1977000,0
"7012",12,"WINTER STORM","WI",0,5e+05,0,1,5e+05,1
"7013",12,"WINTER STORM","WV",0,8500,0,0,8500,0
"7014",12,"WINTER STORM","WY",0,170000,2,40,170000,42
"7015",12,"WINTER WEATHER","CA",0,80000,0,0,80000,0
"7016",12,"WINTER WEATHER","CO",0,30000,0,0,30000,0
"7017",12,"WINTER WEATHER","CT",0,0,0,46,0,46
"7018",12,"WINTER WEATHER","IN",0,65000,0,0,65000,0
"7019",12,"WINTER WEATHER","KS",0,2688000,2,3,2688000,5
"7020",12,"WINTER WEATHER","KY",0,380000,0,4,380000,4
"7021",12,"WINTER WEATHER","MA",0,1e+05,0,5,1e+05,5
"7022",12,"WINTER WEATHER","MD",0,0,2,5,0,7
"7023",12,"WINTER WEATHER","NC",0,70000,2,3,70000,5
"7024",12,"WINTER WEATHER","ND",0,85000,0,0,85000,0
"7025",12,"WINTER WEATHER","NH",0,30000,0,0,30000,0
"7026",12,"WINTER WEATHER","NV",0,20000,0,0,20000,0
"7027",12,"WINTER WEATHER","NY",0,272000,1,0,272000,1
"7028",12,"WINTER WEATHER","OH",0,3e+05,0,0,3e+05,0
"7029",12,"WINTER WEATHER","OK",0,210000,0,6,210000,6
"7030",12,"WINTER WEATHER","OR",0,0,1,1,0,2
"7031",12,"WINTER WEATHER","PA",0,0,0,10,0,10
"7032",12,"WINTER WEATHER","SD",0,85000,0,0,85000,0
"7033",12,"WINTER WEATHER","TN",0,10000,0,0,10000,0
"7034",12,"WINTER WEATHER","TX",0,3539000,11,168,3539000,179
"7035",12,"WINTER WEATHER","VA",0,0,1,50,0,51
"7036",12,"WINTER WEATHER","VT",0,690000,0,0,690000,0
"7037",12,"WINTER WEATHER","WA",0,350000,0,0,350000,0
"7038",12,"WINTER WEATHER","WI",0,294800,0,0,294800,0
"7039",12,"WINTER WEATHER","WY",0,20000,0,0,20000,0
